species_name,sample 1,sample 2,core_diff,core_len,core_len_4D,core_len_1D,core_diff_4D,core_diff_1D,recomb_len_4D,recomb_len_1D,recomb_diff_4D,recomb_diff_1D,clonal_len_4D,clonal_len_1D,clonal_diff_4D,clonal_diff_1D,clonal_n,clonal_m,clonal_nn,recomb_n,recomb_m,recomb_nn,clonal_mut_n,clonal_mut_m,clonal_mut_nn,recomb_mut_n,recomb_mut_m,recomb_mut_nn
Alistipes_onderdonkii_55464,700015702,700024673,2824,1724792,304726,1128784,1221,614,28301,105355,1180,522,276425,1023429,41,92,109355,2955865,5067,11323,304250,492,0,92,0,1,518,3
Alistipes_onderdonkii_55464,700015702,700038414,3273,1675879,295015,1096078,1396,697,38048,141799,1357,598,256967,954279,39,99,102757,2755283,4797,15351,409386,660,0,99,0,2,594,2
Alistipes_onderdonkii_55464,700015702,700101840,3439,1671056,293413,1093400,1508,721,42846,159934,1465,628,250567,933466,43,93,100789,2694914,4695,17172,461865,765,0,93,0,4,623,1
Alistipes_onderdonkii_55464,700015702,700106056,3410,1643389,288326,1074418,1500,706,44988,169097,1472,600,243338,905321,28,106,97892,2613418,4653,18661,487883,747,0,106,0,0,598,2
Alistipes_onderdonkii_55464,700015702,700106876,3442,1729824,305555,1132370,1506,725,42499,158102,1470,635,263056,974268,36,90,103970,2814061,4773,16975,456536,795,1,89,0,3,630,2
Alistipes_onderdonkii_55464,700015702,700107398,3123,1732574,306320,1134218,1358,683,36423,135699,1330,596,269897,998519,28,87,106317,2884281,4959,14681,391798,618,0,87,0,2,592,2
Alistipes_onderdonkii_55464,700015702,SRR2822459,4214,1732432,306204,1134129,1817,913,48138,177725,1780,795,258066,956404,37,118,102030,2762445,4737,18924,513483,768,1,116,1,2,790,3
Alistipes_onderdonkii_55464,700021902,700023267,4893,1686474,296238,1103101,2113,1030,58464,216753,2082,936,237774,886348,31,94,95732,2558914,4398,23290,625940,1029,1,93,0,1,933,2
Alistipes_onderdonkii_55464,700021902,700023845,4281,1524444,263912,996586,1865,861,49715,187203,1820,744,214197,809383,45,117,89023,2335145,3981,20654,539953,1002,0,117,0,1,742,1
Alistipes_onderdonkii_55464,700021902,700024545,4208,1649868,288938,1079642,1816,887,47782,178790,1790,784,241156,900852,26,103,97181,2600926,4449,19420,516101,849,1,102,0,1,781,2
Alistipes_onderdonkii_55464,700021902,700024711,4781,1728989,304905,1131496,2055,1025,54798,203835,2026,906,250107,927661,29,119,99226,2679170,4587,21964,588617,924,1,118,0,3,901,2
Alistipes_onderdonkii_55464,700021902,700033797,2361,1699652,298797,1111833,960,539,28654,107151,920,444,270143,1004682,40,95,108037,2901095,4914,11683,309287,483,0,95,0,3,440,1
Alistipes_onderdonkii_55464,700021902,700099059,1539,1731762,305475,1133415,654,337,20865,77231,631,289,284610,1056184,23,48,112959,3050487,5106,8323,222998,372,0,48,0,0,289,0
Alistipes_onderdonkii_55464,700021902,700103479,3988,1755193,309812,1149011,1724,883,45243,166903,1689,777,264569,982108,35,106,105257,2836240,4827,17564,482383,762,1,105,0,1,774,2
Alistipes_onderdonkii_55464,700021902,700113975,3629,1748192,308986,1144413,1592,768,43091,160347,1550,660,265895,984066,42,108,104961,2842413,4824,17152,463133,756,1,107,0,2,657,1
Alistipes_onderdonkii_55464,700021902,700116730,3441,1748723,309076,1144825,1514,748,38821,143463,1491,635,270255,1001362,23,113,106937,2892229,4920,15230,414469,690,1,112,0,2,632,1
Alistipes_onderdonkii_55464,700021902,700117938,3085,1671191,293162,1092749,1299,709,37137,138242,1271,613,256025,954507,28,96,103860,2754870,4791,14799,399240,687,1,95,0,2,610,1
Alistipes_onderdonkii_55464,700021902,700119739,3952,1748598,309087,1144684,1695,878,43285,159809,1658,749,265802,984875,37,129,105198,2844606,4821,16969,461699,759,0,129,0,2,746,1
Alistipes_onderdonkii_55464,700021902,700120753,4414,1743857,308180,1141593,1928,957,47087,174051,1890,859,261093,967542,38,98,103239,2794707,4680,18606,502704,843,0,98,0,1,858,0
Alistipes_onderdonkii_55464,700021902,700163772,3763,1696262,298608,1109666,1576,848,43216,160655,1546,738,255392,949011,30,110,102279,2740008,4746,17226,463974,765,1,109,0,4,733,1
Alistipes_onderdonkii_55464,700021902,ERR911992,4116,1755903,310279,1149424,1791,909,51726,190972,1760,791,258553,958452,31,118,102396,2768235,4725,20296,551741,879,1,116,1,1,788,2
Alistipes_onderdonkii_55464,700021902,ERR912076,3331,1763109,311419,1154291,1463,720,38604,143067,1421,623,272815,1011224,42,97,107962,2920772,4938,15269,413260,672,0,97,0,3,619,1
Alistipes_onderdonkii_55464,700021902,ERR912126,3662,1739203,307207,1138357,1605,788,43068,159903,1577,697,264139,978454,28,91,104464,2826125,4773,17121,461790,798,1,90,0,2,693,2
Alistipes_onderdonkii_55464,700023267,700023634,4754,1680685,295286,1099244,2010,1068,52361,193744,1990,963,242925,905500,20,105,97818,2614167,4515,20811,559506,915,0,105,0,0,962,1
Alistipes_onderdonkii_55464,700023267,700023845,3457,1504182,260269,982956,1431,742,37952,141779,1404,646,222317,841177,27,96,93003,2426271,4257,15377,409195,765,0,96,0,0,645,1
Alistipes_onderdonkii_55464,700023267,700024086,4691,1665474,292165,1089318,1909,1073,52592,195401,1887,967,239573,893917,22,106,96961,2580413,4377,20866,564308,1029,0,106,0,1,965,1
Alistipes_onderdonkii_55464,700023267,700024545,899,1622005,283567,1060800,394,208,11119,41238,381,169,272448,1019562,13,39,110742,2942772,5172,4391,119140,183,0,39,0,0,169,0
Alistipes_onderdonkii_55464,700023267,700024711,1549,1679581,294973,1098422,647,353,18620,69000,635,292,276353,1029422,12,61,111322,2971748,5196,7312,199379,309,2,59,0,0,292,0
Alistipes_onderdonkii_55464,700023267,700033797,4254,1659418,290899,1085019,1833,876,45410,169205,1809,785,245489,915814,24,91,99225,2643660,4557,18242,488617,756,0,91,0,1,783,1
Alistipes_onderdonkii_55464,700023267,700037632,3910,1620735,282795,1060035,1647,844,43874,163228,1621,724,238921,896807,26,120,97901,2588014,4506,17470,471440,774,0,120,0,0,723,1
Alistipes_onderdonkii_55464,700023267,700038263,3587,1597042,277740,1044256,1499,775,39038,146249,1478,701,238702,898007,21,74,98387,2591134,4500,15859,422099,789,0,74,0,0,700,1
Alistipes_onderdonkii_55464,700023267,700103479,3520,1688144,296371,1104254,1475,795,39512,146437,1461,696,256859,957817,14,99,103703,2764957,4791,15558,423066,687,0,99,0,1,693,2
Alistipes_onderdonkii_55464,700023267,700111156,3509,1685110,296011,1102267,1471,787,40441,150145,1453,700,255570,952122,18,87,102912,2748696,4758,16049,433702,684,0,87,0,0,699,1
Alistipes_onderdonkii_55464,700023267,700111296,4017,1675754,294417,1096134,1709,905,41097,152659,1691,831,253320,943475,18,74,101753,2723929,4743,16520,440770,687,0,74,0,2,827,2
Alistipes_onderdonkii_55464,700023267,700113975,2917,1679534,295164,1098556,1213,647,34016,126887,1184,569,261148,971669,29,78,104899,2805239,4869,13591,366491,579,0,78,0,1,567,1
Alistipes_onderdonkii_55464,700023267,700116730,2892,1680765,295384,1099390,1237,656,31089,114899,1216,572,264295,984491,21,84,106325,2842249,4899,12225,331911,561,1,83,0,0,571,1
Alistipes_onderdonkii_55464,700023267,700117938,4470,1628811,284791,1064510,1907,963,49028,182320,1882,859,235763,882190,25,104,96590,2545435,4545,19637,526471,852,0,104,0,1,857,1
Alistipes_onderdonkii_55464,700023267,700119739,3317,1680120,295324,1098909,1400,738,35845,132913,1379,644,259479,965996,21,94,104225,2788978,4785,14298,383799,642,0,94,0,0,643,1
Alistipes_onderdonkii_55464,700023267,700120753,4509,1675193,294390,1095689,1877,1050,44982,166248,1856,947,249408,929441,21,103,100379,2683375,4569,17820,480132,792,0,103,0,1,944,2
Alistipes_onderdonkii_55464,700023267,700164735,3776,1685125,296032,1102234,1589,839,43088,159887,1549,727,252944,942347,40,112,101716,2720669,4656,17166,461730,765,0,112,0,0,725,2
Alistipes_onderdonkii_55464,700023267,ERR911956,3780,1684944,296111,1102052,1601,817,43066,158105,1587,743,253045,943947,14,74,102316,2724761,4764,16619,456991,705,0,74,0,1,740,2
Alistipes_onderdonkii_55464,700023267,ERR911988,3854,1676258,294608,1096346,1659,852,43870,162214,1633,770,250738,934132,26,82,101248,2696453,4695,17042,468895,705,0,82,0,0,769,1
Alistipes_onderdonkii_55464,700023267,ERR911992,3725,1685466,296123,1102393,1549,840,42342,156346,1526,752,253781,946047,23,88,102228,2731143,4770,16748,451588,702,0,88,0,0,749,3
Alistipes_onderdonkii_55464,700023267,ERR912037,3855,1687695,296520,1103859,1622,856,44348,164277,1595,748,252172,939582,27,108,101562,2712492,4692,17595,474465,771,0,108,0,0,746,2
Alistipes_onderdonkii_55464,700023267,ERR912076,2741,1688908,296687,1104708,1175,612,31933,118486,1160,554,264754,986222,15,58,106573,2847134,4959,12655,342269,534,0,58,0,1,552,1
Alistipes_onderdonkii_55464,700023267,ERR912078,4722,1683343,295676,1101071,1961,1087,52113,192744,1929,980,243563,908327,32,107,98266,2622200,4515,20624,556651,957,0,107,0,2,978,0
Alistipes_onderdonkii_55464,700023267,ERR912126,2769,1666577,292785,1089820,1185,623,28002,103732,1169,566,264783,986088,16,57,106481,2846863,4920,11195,299482,519,1,56,0,0,564,2
Alistipes_onderdonkii_55464,700023267,mickey4-11-0-0_,3557,1680464,294954,1099208,1518,793,49182,182017,1492,704,245772,917191,26,89,99069,2647932,4572,19587,525579,885,1,88,0,0,704,0
Alistipes_onderdonkii_55464,700023267,pluto3-11-7-0_,3620,1670597,293334,1092830,1526,754,43760,162853,1502,665,249574,929977,24,89,100248,2685135,4548,17670,470082,807,0,89,0,1,664,0
Alistipes_onderdonkii_55464,700023634,700023845,1846,1517334,262800,991811,779,415,18794,70589,756,338,244006,921222,23,77,101368,2657672,4626,7791,203589,387,0,77,0,0,336,2
Alistipes_onderdonkii_55464,700023634,700023872,5946,1712522,302127,1120900,2567,1355,69891,258239,2548,1253,232236,862661,19,102,92340,2491431,4212,27767,745720,1230,0,102,0,4,1247,2
Alistipes_onderdonkii_55464,700023634,700024086,3182,1715428,302229,1122657,1322,737,35594,132215,1304,651,266635,990442,18,86,106371,2860137,4818,14114,381844,687,1,85,0,0,649,2
Alistipes_onderdonkii_55464,700023634,700024545,4085,1644888,288126,1076344,1707,912,42797,159278,1685,807,245329,917066,22,105,98951,2647702,4545,17302,459776,756,0,105,0,0,806,1
Alistipes_onderdonkii_55464,700023634,700024711,4604,1722571,303843,1127208,1924,1028,49060,181791,1904,917,254783,945417,20,111,101186,2730424,4641,19577,524914,882,1,110,0,1,915,1
Alistipes_onderdonkii_55464,700023634,700033797,4916,1690728,297275,1105904,2094,1057,53587,200265,2071,945,243688,905639,23,112,97366,2615126,4425,21718,578165,912,0,112,0,1,944,0
Alistipes_onderdonkii_55464,700023634,700037632,2939,1647366,287992,1078012,1217,635,33506,124347,1184,512,254486,953665,33,123,103390,2752865,4740,13400,359050,591,0,123,0,0,512,0
Alistipes_onderdonkii_55464,700023634,700038263,1937,1613964,280960,1055628,830,427,20103,75728,802,359,260857,979900,28,68,106894,2827916,4890,8325,218460,399,0,68,0,0,357,2
Alistipes_onderdonkii_55464,700023634,700103479,3741,1746439,308295,1143198,1571,871,40053,147527,1551,761,268242,995671,20,110,106642,2875493,4878,15580,426311,690,0,110,0,2,758,1
Alistipes_onderdonkii_55464,700023634,700111156,3718,1743219,307944,1141073,1552,865,43060,159138,1530,749,264884,981935,22,116,104971,2836037,4797,16968,459702,744,0,116,0,0,749,0
Alistipes_onderdonkii_55464,700023634,700111296,4196,1734646,306456,1135413,1757,980,44134,162853,1739,882,262322,972560,18,98,103922,2809000,4758,17379,470409,771,0,97,1,2,880,0
Alistipes_onderdonkii_55464,700023634,700113975,3452,1741361,307737,1139854,1449,795,37412,138218,1409,687,270325,1001636,40,108,106903,2893079,4926,14768,399241,645,0,108,0,1,686,0
Alistipes_onderdonkii_55464,700023634,700116730,3140,1740851,307639,1139568,1310,742,34971,128839,1287,645,272668,1010729,23,97,108029,2919190,4968,13678,372221,618,1,96,0,0,645,0
Alistipes_onderdonkii_55464,700023634,700119739,3485,1740084,307582,1138963,1449,830,38997,143559,1426,722,268585,995404,23,108,106418,2874925,4869,15203,414787,687,0,108,0,0,722,0
Alistipes_onderdonkii_55464,700023634,700120753,2004,1739634,307352,1138734,810,485,21065,77819,782,388,286287,1060915,28,97,113283,3064287,5175,8328,224790,339,0,97,0,1,386,1
Alistipes_onderdonkii_55464,700023634,700164735,3845,1746026,308391,1142905,1637,887,42642,157558,1589,754,265749,985347,48,133,105280,2846009,4752,16782,455124,768,0,133,0,1,752,1
Alistipes_onderdonkii_55464,700023634,700171115,2750,1729541,305377,1131933,1153,612,32043,119971,1121,522,273334,1011962,32,90,107971,2922926,4989,13016,346330,567,2,88,0,2,519,1
Alistipes_onderdonkii_55464,700023634,ERR911956,4032,1744660,308330,1141957,1710,899,45206,164978,1684,808,263124,976979,26,91,104568,2821536,4833,17381,476794,759,0,91,0,1,806,1
Alistipes_onderdonkii_55464,700023634,ERR911988,3800,1736015,306808,1136278,1613,855,44254,163555,1589,747,262554,972723,24,108,104128,2809253,4788,17224,472709,732,0,108,0,0,747,0
Alistipes_onderdonkii_55464,700023634,ERR911992,3921,1744630,308259,1141920,1625,930,42672,156931,1604,822,265587,984989,21,108,105384,2844717,4866,16611,453477,705,0,107,1,0,821,1
Alistipes_onderdonkii_55464,700023634,ERR912033,3719,1741838,307778,1140141,1582,872,45077,167048,1553,752,262701,973093,29,120,104201,2810290,4788,17635,482744,765,0,120,0,1,750,1
Alistipes_onderdonkii_55464,700023634,ERR912036,3131,1743454,308050,1141133,1354,669,34221,126525,1327,571,273829,1014608,27,98,108442,2930381,5001,13465,365546,564,1,97,0,0,570,1
Alistipes_onderdonkii_55464,700023634,ERR912037,4112,1746690,308600,1143314,1710,951,47248,173815,1677,837,261352,969499,33,114,103839,2799903,4755,18363,502287,795,0,114,0,0,836,1
Alistipes_onderdonkii_55464,700023634,ERR912061,4303,1738379,307112,1137826,1826,1013,50614,187898,1799,887,256498,949928,27,126,101756,2743432,4596,19817,542941,936,1,125,0,1,884,2
Alistipes_onderdonkii_55464,700023634,ERR912076,3071,1748034,308821,1144194,1283,718,33312,123207,1257,628,275509,1020987,26,90,109135,2948813,5013,13116,355941,564,0,90,0,1,627,0
Alistipes_onderdonkii_55464,700023634,ERR912078,2921,1743657,308026,1141308,1230,713,30854,112821,1202,620,277172,1028487,28,93,110054,2970373,5034,11949,325983,531,0,93,0,2,617,1
Alistipes_onderdonkii_55464,700023634,ERR912126,3363,1725183,304823,1128976,1418,762,39349,145465,1400,679,265474,983511,18,83,105115,2840612,4806,15546,420123,726,1,82,0,0,678,1
Alistipes_onderdonkii_55464,700023634,ERR912128,3832,1734959,306556,1135394,1633,895,46960,173517,1607,781,259596,961877,26,114,102988,2777915,4728,18513,501249,789,0,113,1,2,777,2
Alistipes_onderdonkii_55464,700023634,ERR912159,4278,1730165,305385,1132375,1844,916,49150,182349,1822,794,256235,950026,22,122,101604,2743830,4644,19574,526579,894,0,122,0,1,792,1
Alistipes_onderdonkii_55464,700023634,ERR912188,4411,1749501,309061,1145234,1863,992,46639,173874,1850,894,262422,971360,13,98,103591,2805740,4749,18805,501992,825,1,97,0,2,890,2
Alistipes_onderdonkii_55464,700023634,mickey4-11-0-0_,4156,1732714,305711,1134113,1764,948,48862,179718,1712,835,256849,954395,52,113,102166,2756372,4647,19168,519134,852,1,112,0,0,835,0
Alistipes_onderdonkii_55464,700023634,pluto3-11-7-0_,4023,1724788,304442,1129057,1659,882,49377,183040,1634,768,255065,946017,25,114,100881,2732556,4614,19813,528467,840,0,114,0,1,767,0
Alistipes_onderdonkii_55464,700023845,700023872,4296,1504317,260356,983536,1831,949,46395,174420,1805,870,213961,809116,26,79,88970,2334403,3975,19324,502964,972,0,79,0,4,866,0
Alistipes_onderdonkii_55464,700023845,700024086,1403,1507741,260887,985513,562,327,15059,56788,546,264,245828,928725,16,63,102549,2678973,4653,6068,163942,354,0,63,0,1,263,0
Alistipes_onderdonkii_55464,700023845,700024545,2801,1473440,254409,963037,1140,606,29089,109446,1105,514,225320,853591,35,92,94262,2462149,4362,12070,315710,558,0,92,0,0,513,1
Alistipes_onderdonkii_55464,700023845,700024711,3281,1512281,261828,988447,1334,716,35429,133210,1299,611,226399,855237,35,105,94184,2467216,4311,14655,384282,693,1,104,0,1,609,1
Alistipes_onderdonkii_55464,700023845,700033797,4083,1509523,261248,986532,1758,822,42950,162180,1730,720,218298,824352,28,102,90814,2378159,4083,17845,467867,828,0,102,0,1,717,2
Alistipes_onderdonkii_55464,700023845,700037632,2337,1493750,257675,976515,992,503,23859,90405,958,393,233816,886110,34,110,98051,2555848,4431,9864,260844,507,0,110,0,0,391,2
Alistipes_onderdonkii_55464,700023845,700038263,489,1498036,258496,979077,202,112,4205,16327,179,67,254291,962750,23,45,106473,2776926,4851,1778,47089,114,0,45,0,0,67,0
Alistipes_onderdonkii_55464,700023845,700103479,2961,1520961,263180,994291,1254,637,28316,105885,1222,544,234864,888406,32,93,97988,2562808,4422,11502,305577,576,0,93,0,0,541,3
Alistipes_onderdonkii_55464,700023845,700111156,3135,1520807,263297,994208,1302,701,31434,117479,1264,587,231863,876729,38,114,96798,2529012,4377,12659,339199,579,0,114,0,1,584,2
Alistipes_onderdonkii_55464,700023845,700111296,3584,1508522,261214,986156,1527,777,34204,128677,1497,662,227010,857479,30,115,94466,2473675,4296,14050,371309,672,1,113,1,0,660,2
Alistipes_onderdonkii_55464,700023845,700113975,2753,1509986,261513,987060,1137,612,27099,102211,1104,511,234414,884849,33,101,97415,2552659,4473,11164,294959,510,0,101,0,1,508,2
Alistipes_onderdonkii_55464,700023845,700116730,2548,1512322,261952,988627,1067,571,24046,89862,1046,484,237906,898765,21,87,99037,2592776,4482,9738,259332,516,1,86,0,0,482,2
Alistipes_onderdonkii_55464,700023845,700117938,3864,1484883,256417,970105,1675,804,42449,160011,1648,682,213968,810094,27,122,90151,2336003,4128,17439,461715,879,0,122,0,1,679,2
Alistipes_onderdonkii_55464,700023845,700119739,2984,1512005,261944,988353,1238,683,28283,105603,1211,579,233661,882750,27,104,97262,2546596,4392,11475,304734,600,0,103,1,0,578,1
Alistipes_onderdonkii_55464,700023845,700120753,1479,1509461,261402,986715,606,331,12604,47584,577,256,248798,939131,29,75,103315,2709374,4704,5262,137256,234,0,75,0,0,255,1
Alistipes_onderdonkii_55464,700023845,700164735,3332,1517448,262756,991951,1403,725,32728,122746,1359,614,230028,869205,44,111,95720,2507584,4311,13354,354230,654,0,111,0,0,611,3
Alistipes_onderdonkii_55464,700023845,700171115,2101,1511012,261538,987630,921,425,23642,89546,885,353,237896,898084,36,72,98723,2591008,4521,9971,258190,477,2,70,0,1,351,1
Alistipes_onderdonkii_55464,700023845,ERR911956,3397,1518197,262944,992458,1432,731,32422,120525,1402,639,230522,871933,30,92,96128,2515249,4422,13087,347906,582,0,92,0,1,635,3
Alistipes_onderdonkii_55464,700023845,ERR911972,3922,1522163,263444,995102,1666,880,43108,162055,1642,782,220336,833047,24,98,91726,2403302,4113,17859,467409,897,0,98,0,3,778,1
Alistipes_onderdonkii_55464,700023845,ERR911988,3197,1513369,262057,989308,1369,675,32199,120625,1339,569,229858,868683,30,106,95903,2505820,4326,12939,348321,615,0,106,0,0,567,2
Alistipes_onderdonkii_55464,700023845,ERR911992,3154,1519180,263067,993028,1321,705,30423,113294,1293,603,232644,879734,28,102,97021,2537762,4419,12249,327042,591,0,101,1,1,599,3
Alistipes_onderdonkii_55464,700023845,ERR912033,3142,1519954,263155,993662,1364,698,35106,132284,1317,583,228049,861378,47,115,95087,2484712,4335,14298,381897,657,0,115,0,1,581,1
Alistipes_onderdonkii_55464,700023845,ERR912036,2373,1519514,263125,993278,1034,467,22032,83090,1004,382,241093,910188,30,85,100227,2625708,4629,9086,239803,381,1,84,0,1,380,1
Alistipes_onderdonkii_55464,700023845,ERR912037,3424,1527158,264415,998350,1429,750,38461,144399,1406,646,225954,853951,23,104,94167,2463462,4224,15738,416682,777,0,104,0,0,643,3
Alistipes_onderdonkii_55464,700023845,ERR912061,2651,1516016,262492,990977,1064,622,30112,113744,1031,518,232380,877233,33,104,96813,2530443,4443,12205,328454,573,1,103,0,1,517,0
Alistipes_onderdonkii_55464,700023845,ERR912076,2412,1525989,264152,997593,1022,525,24900,93821,1002,450,239252,903772,20,75,99595,2607194,4527,10185,270786,492,0,75,0,1,447,2
Alistipes_onderdonkii_55464,700023845,ERR912078,1337,1523852,263771,996264,537,340,14523,54136,511,257,249248,942128,26,83,103845,2717778,4761,5833,156290,285,0,83,0,2,254,1
Alistipes_onderdonkii_55464,700023845,ERR912126,2719,1515214,262322,990423,1167,583,26950,101465,1140,502,235372,888958,27,81,97886,2564572,4416,11098,292724,573,1,80,0,0,499,3
Alistipes_onderdonkii_55464,700023845,ERR912128,2964,1512552,261976,988576,1314,645,34222,128421,1286,539,227754,860155,28,106,94863,2481264,4338,14043,370578,642,0,105,1,1,536,2
Alistipes_onderdonkii_55464,700023845,ERR912159,3485,1512220,261720,988489,1529,686,40253,152054,1499,573,221467,836435,30,113,91999,2413103,4203,16873,438497,792,0,113,0,0,572,1
Alistipes_onderdonkii_55464,700023845,ERR912188,2814,1530527,264972,1000635,1187,610,30020,113825,1165,525,234952,886810,22,85,97512,2558454,4464,12608,328294,573,1,84,0,1,524,0
Alistipes_onderdonkii_55464,700023845,mickey4-11-0-0_,3467,1518931,262778,993017,1454,764,38001,141890,1401,668,224777,851127,53,96,93837,2455290,4254,15488,409414,768,0,96,0,0,667,1
Alistipes_onderdonkii_55464,700023845,pluto3-11-7-0_,3332,1509701,261282,986944,1369,677,36796,139109,1335,576,224486,847835,34,101,93120,2446173,4212,15476,401146,705,0,101,0,1,574,1
Alistipes_onderdonkii_55464,700023872,700024086,5790,1688185,297204,1104888,2470,1328,69142,256553,2447,1220,228062,848335,23,108,91184,2449705,4116,27604,740777,1278,0,108,0,5,1215,0
Alistipes_onderdonkii_55464,700023872,700024545,6308,1636866,286559,1071163,2641,1432,75408,280003,2612,1320,211151,791160,29,112,85479,2284107,3894,30371,808291,1347,0,112,0,4,1315,1
Alistipes_onderdonkii_55464,700023872,700037632,5849,1631218,285022,1067616,2506,1296,64282,239047,2471,1182,220740,828569,35,114,89751,2391882,4074,26014,689948,1179,0,114,0,3,1177,2
Alistipes_onderdonkii_55464,700023872,700038263,4592,1599121,278243,1046164,1983,1014,48209,180689,1959,934,230034,865475,24,80,94409,2497759,4257,19844,521293,930,0,80,0,4,930,0
Alistipes_onderdonkii_55464,700023872,700113975,6572,1710296,301891,1119546,2783,1536,74211,273968,2742,1421,227680,845578,41,115,90227,2442343,4164,29590,791075,1239,0,115,0,5,1414,2
Alistipes_onderdonkii_55464,700023872,700116730,6326,1712624,302315,1121115,2691,1469,70859,261670,2660,1351,231456,859445,31,118,91783,2482367,4185,28225,755534,1251,1,117,0,4,1345,2
Alistipes_onderdonkii_55464,700023872,700120753,5625,1707554,301378,1117712,2417,1279,61035,225560,2378,1181,240343,892152,39,98,95260,2576849,4347,24400,651239,1041,0,98,0,4,1176,1
Alistipes_onderdonkii_55464,700023872,700171115,6354,1701897,300092,1113872,2731,1440,70352,259574,2689,1321,229740,854298,42,119,91415,2467288,4191,27961,749537,1224,2,117,0,5,1315,1
Alistipes_onderdonkii_55464,700023872,ERR912036,6231,1717053,303037,1123920,2719,1369,66314,244969,2680,1258,236723,878951,39,111,93944,2538553,4356,26448,707364,1095,1,110,0,4,1253,1
Alistipes_onderdonkii_55464,700023872,ERR912076,6261,1724850,304247,1129169,2672,1440,72950,269214,2643,1345,231297,859955,29,95,92024,2483608,4233,28894,777524,1224,0,95,0,5,1338,2
Alistipes_onderdonkii_55464,700023872,ERR912078,6040,1721023,303594,1126636,2572,1428,70677,260137,2537,1321,232917,866499,35,107,92770,2502536,4191,27947,751198,1266,1,106,0,5,1315,1
Alistipes_onderdonkii_55464,700023872,ERR912126,6533,1700440,300002,1112901,2803,1492,76705,283238,2774,1387,223297,829663,29,105,88663,2396279,4047,30567,817779,1368,1,104,0,4,1380,3
Alistipes_onderdonkii_55464,700023872,ERR912188,6232,1727308,304698,1130840,2684,1408,66757,247038,2656,1301,237941,883802,28,107,94429,2552699,4278,26674,713246,1194,1,106,0,3,1298,0
Alistipes_onderdonkii_55464,700024086,700024545,3988,1637644,286625,1071504,1597,932,42867,160287,1563,821,243758,911217,34,111,98626,2630537,4488,17261,462784,816,0,111,0,1,819,1
Alistipes_onderdonkii_55464,700024086,700024711,4487,1701702,299506,1113471,1798,1046,50964,190357,1770,941,248542,923114,28,105,99213,2665641,4488,20462,549628,981,1,104,0,2,938,1
Alistipes_onderdonkii_55464,700024086,700037632,3559,1634278,285400,1069381,1494,774,38599,144048,1470,666,246801,925333,24,108,100589,2670847,4563,15486,415923,735,0,108,0,1,663,2
Alistipes_onderdonkii_55464,700024086,700038263,1512,1603062,278869,1048481,615,337,16536,62855,593,286,262333,985626,22,51,107830,2844161,4887,6761,181399,405,1,50,0,0,286,0
Alistipes_onderdonkii_55464,700024086,700103479,4434,1718885,302659,1125001,1864,1032,47165,174328,1846,919,255494,950673,18,113,102339,2745066,4614,18451,503651,882,0,113,0,2,914,3
Alistipes_onderdonkii_55464,700024086,700111156,4333,1715499,302253,1122805,1817,997,45967,170484,1787,889,256286,952321,30,108,102466,2749844,4653,18037,492599,816,0,108,0,1,886,2
Alistipes_onderdonkii_55464,700024086,700111296,5063,1706303,300614,1116724,2116,1178,50808,188308,2099,1067,249806,928416,17,111,99699,2681049,4500,20110,543851,963,0,110,1,3,1062,2
Alistipes_onderdonkii_55464,700024086,700113975,4193,1712210,301738,1120627,1728,984,42469,158024,1687,873,259269,962603,41,111,103374,2779737,4698,16818,456474,780,0,111,0,2,869,2
Alistipes_onderdonkii_55464,700024086,700116730,3894,1712675,301805,1120959,1630,912,38698,143295,1608,825,263107,977664,22,87,105063,2823150,4779,15204,413964,717,1,86,0,1,822,2
Alistipes_onderdonkii_55464,700024086,700119739,4301,1711528,301667,1120157,1782,1016,44820,165887,1761,912,256847,954270,21,104,102673,2755505,4632,17490,479331,840,0,103,1,1,910,1
Alistipes_onderdonkii_55464,700024086,700120753,2654,1711267,301543,1120059,1084,614,25833,96605,1059,535,275710,1023454,25,79,109798,2955590,4974,10325,279016,474,1,78,0,0,534,1
Alistipes_onderdonkii_55464,700024086,700171115,3389,1703448,299975,1114747,1439,750,37118,138169,1403,659,262857,976578,36,91,104805,2820153,4776,14873,398932,702,3,88,0,1,657,1
Alistipes_onderdonkii_55464,700024086,ERR911956,4809,1715772,302370,1122904,2013,1080,49525,182496,1989,989,252845,940408,24,91,101218,2715344,4662,19263,527367,858,0,91,0,2,984,3
Alistipes_onderdonkii_55464,700024086,ERR911972,5295,1710787,301322,1119627,2244,1245,60340,223522,2219,1146,240982,896105,25,99,96364,2587664,4287,23888,645493,1185,1,98,0,4,1141,1
Alistipes_onderdonkii_55464,700024086,ERR911988,4550,1706644,300772,1116884,1926,1030,51026,189311,1904,922,249746,927573,22,108,99903,2678316,4500,19949,547042,942,0,108,0,0,920,2
Alistipes_onderdonkii_55464,700024086,ERR911992,4478,1715655,302329,1122795,1844,1047,49185,181127,1819,951,253144,941668,25,96,101451,2718918,4635,19043,523495,843,1,94,1,0,948,3
Alistipes_onderdonkii_55464,700024086,ERR912036,3563,1714896,302177,1122260,1526,766,36623,135560,1500,671,265554,986700,26,95,105973,2849279,4848,14444,391567,669,1,94,0,0,670,1
Alistipes_onderdonkii_55464,700024086,ERR912037,4582,1718590,302790,1124768,1914,1063,49934,184573,1884,966,252856,940195,30,97,101204,2714791,4590,19528,533303,888,0,97,0,1,962,3
Alistipes_onderdonkii_55464,700024086,ERR912061,3752,1711135,301470,1119827,1530,903,44148,164456,1502,784,257322,955371,28,119,102954,2758479,4680,17219,475297,852,0,119,0,0,784,0
Alistipes_onderdonkii_55464,700024086,ERR912076,3802,1719109,302830,1125137,1575,886,38958,144787,1553,806,263872,980350,22,80,105455,2830795,4800,15313,418346,702,0,80,0,2,802,2
Alistipes_onderdonkii_55464,700024086,ERR912078,2487,1716657,302416,1123516,998,635,27748,101846,971,543,274668,1021670,27,92,110032,2949932,5046,10604,294442,492,0,92,0,2,540,1
Alistipes_onderdonkii_55464,700024086,ERR912126,4067,1695569,298732,1109461,1717,923,40114,148759,1687,832,258618,960702,30,91,103216,2774225,4665,15878,429613,786,1,90,0,1,828,3
Alistipes_onderdonkii_55464,700024086,ERR912128,4317,1707040,300791,1116994,1858,986,49234,182435,1830,865,251557,934559,28,121,100546,2698541,4590,19473,526965,867,1,118,2,1,863,1
Alistipes_onderdonkii_55464,700024086,ERR912159,4831,1703738,299964,1114919,2083,1025,57488,214016,2060,922,242476,900903,23,103,96717,2601603,4389,23098,617870,1080,0,103,0,0,921,1
Alistipes_onderdonkii_55464,700024086,ERR912188,4012,1721074,303210,1126453,1641,931,46324,173402,1618,845,256886,953051,23,86,102267,2752200,4686,18616,500750,840,1,85,0,2,843,0
Alistipes_onderdonkii_55464,700024545,700024711,736,1645859,288253,1076887,292,183,7038,26408,276,134,281215,1050479,16,49,113504,3032659,5274,2866,76277,81,2,47,0,0,134,0
Alistipes_onderdonkii_55464,700024545,700033797,3502,1624677,284107,1062726,1509,712,36218,136422,1488,632,247889,926304,21,80,100226,2674111,4575,14957,393697,612,0,80,0,1,630,1
Alistipes_onderdonkii_55464,700024545,700037632,3428,1589059,276648,1039664,1438,739,37073,138589,1413,636,239575,901075,25,103,98172,2600523,4530,15021,400086,660,0,103,0,0,635,1
Alistipes_onderdonkii_55464,700024545,700038263,2896,1563833,271404,1022786,1188,637,30901,116680,1161,561,240503,906106,27,76,99194,2614579,4545,12809,336613,618,0,76,0,0,560,1
Alistipes_onderdonkii_55464,700024545,700099059,4133,1629620,285310,1066169,1799,858,45124,168982,1775,764,240186,897187,24,94,96789,2590356,4416,18449,487711,786,1,93,0,1,761,2
Alistipes_onderdonkii_55464,700024545,700103479,2777,1650615,288967,1080170,1178,631,30716,114240,1163,553,258251,965930,15,78,104433,2788575,4782,12275,329914,531,0,78,0,2,549,2
Alistipes_onderdonkii_55464,700024545,700111156,2755,1648993,288830,1079061,1153,611,29876,111742,1126,536,258954,967319,27,75,104437,2792687,4833,12118,322637,471,0,75,0,0,535,1
Alistipes_onderdonkii_55464,700024545,700111296,3279,1641156,287502,1073909,1405,739,33512,125201,1389,668,253990,948708,16,71,102261,2739138,4725,13682,361375,546,0,70,1,2,665,1
Alistipes_onderdonkii_55464,700024545,700113975,2126,1645987,288424,1077093,878,468,23879,89434,851,408,264545,987659,27,60,106592,2851441,4944,9674,258271,357,0,60,0,1,406,1
Alistipes_onderdonkii_55464,700024545,700116730,2087,1645692,288312,1076970,891,482,21913,81602,878,423,266399,995368,13,59,107382,2873778,4944,8871,235575,360,1,58,0,0,422,1
Alistipes_onderdonkii_55464,700024545,700117938,3707,1604544,280027,1049111,1581,791,39135,146320,1561,700,240892,902791,20,91,98489,2605300,4584,15940,422318,702,0,91,0,1,698,1
Alistipes_onderdonkii_55464,700024545,700119739,2615,1644927,288262,1076372,1076,600,25531,94857,1056,526,262731,981515,20,74,105839,2833846,4860,10363,273767,441,0,74,0,0,525,1
Alistipes_onderdonkii_55464,700024545,700120753,3785,1640700,287443,1073609,1565,894,35219,131468,1535,803,252224,942141,30,91,101627,2720131,4665,14294,379516,594,0,91,0,1,800,2
Alistipes_onderdonkii_55464,700024545,700163772,4160,1616218,282715,1057121,1801,861,48785,182748,1768,776,233930,874373,33,85,94862,2523826,4431,19824,527574,846,2,83,0,2,773,1
Alistipes_onderdonkii_55464,700024545,700164735,3112,1648513,288764,1078748,1314,694,32338,120783,1280,609,256426,957965,34,85,103252,2765945,4698,13189,348572,588,0,85,0,1,606,2
Alistipes_onderdonkii_55464,700024545,700171115,4498,1633771,286073,1068959,1876,1020,49024,183277,1840,914,237049,885682,36,106,95502,2557122,4422,19966,529004,861,2,104,0,3,909,2
Alistipes_onderdonkii_55464,700024545,ERR911956,2966,1646832,288538,1077652,1259,640,31308,115536,1244,586,257230,962116,15,54,104005,2777549,4794,12365,333721,522,0,54,0,1,583,2
Alistipes_onderdonkii_55464,700024545,ERR911988,3041,1637563,286937,1071504,1311,681,32041,120129,1274,597,254896,951375,37,84,102871,2746490,4764,12839,347056,492,0,84,0,0,596,1
Alistipes_onderdonkii_55464,700024545,ERR911992,2812,1647242,288545,1077903,1158,651,31094,115582,1135,574,257451,962321,23,77,103790,2778337,4836,12604,333662,480,0,76,1,0,572,2
Alistipes_onderdonkii_55464,700024545,ERR912036,4694,1642676,287779,1074869,2003,1010,45659,170254,1962,896,242120,904615,41,114,97664,2611603,4578,18423,491622,717,1,113,0,0,894,2
Alistipes_onderdonkii_55464,700024545,ERR912037,3159,1648706,288781,1078841,1305,717,34497,128440,1271,619,254284,950401,34,98,102710,2743762,4731,13848,370902,570,0,98,0,0,617,2
Alistipes_onderdonkii_55464,700024545,ERR912076,1904,1649975,288943,1079725,804,431,19251,72505,787,390,269692,1007220,17,41,108645,2907993,5022,7982,209227,306,0,41,0,1,388,1
Alistipes_onderdonkii_55464,700024545,ERR912078,3965,1644635,287992,1076234,1622,935,42338,157136,1597,839,245654,919098,25,96,99376,2653337,4581,16914,453765,729,0,96,0,2,837,0
Alistipes_onderdonkii_55464,700024545,ERR912126,1967,1628387,285201,1065349,839,441,19198,71797,828,406,266003,993552,11,35,107181,2868558,4917,7917,207111,363,1,34,0,0,404,2
Alistipes_onderdonkii_55464,700024545,ERR912188,4975,1648882,288780,1079033,2053,1132,55250,207312,2033,1024,233530,871721,20,108,93967,2516888,4308,22590,598335,1011,1,107,0,2,1021,1
Alistipes_onderdonkii_55464,700024545,mickey4-11-0-0_,2897,1643076,287622,1075172,1214,656,36946,137383,1183,580,250676,937789,31,76,101280,2707446,4641,14947,396524,678,1,75,0,0,580,0
Alistipes_onderdonkii_55464,700024545,pluto3-11-7-0_,2958,1633601,286041,1069040,1233,625,35649,133947,1210,547,250392,935093,23,78,100758,2699946,4575,14733,386460,648,0,78,0,1,546,0
Alistipes_onderdonkii_55464,700024615,700099886,1126,1718402,301479,1123913,480,247,12825,47784,465,200,288654,1076129,15,47,116379,3105981,6027,5140,137978,234,0,47,0,1,199,0
Alistipes_onderdonkii_55464,700024615,700101581,759,1737626,305248,1136561,314,156,6825,25962,311,136,298423,1110599,3,20,119767,3205736,6294,2937,74838,111,1,19,0,0,136,0
Alistipes_onderdonkii_55464,700024673,700038414,1803,1686544,296795,1102834,770,379,19180,72066,741,312,277615,1030768,29,67,111181,2975957,5166,7798,208082,318,0,67,0,1,310,1
Alistipes_onderdonkii_55464,700024673,700095486,2784,1642373,287556,1073946,1233,648,35183,130641,1184,519,252373,943305,49,129,102603,2722506,4806,14010,377301,612,1,128,0,0,518,1
Alistipes_onderdonkii_55464,700024673,700097688,3139,1701629,299530,1113564,1325,731,39702,148889,1277,612,259828,964675,48,119,103365,2785971,4689,16155,429783,729,1,117,1,1,607,4
Alistipes_onderdonkii_55464,700024673,700101840,1781,1679528,294832,1098657,793,396,23037,86995,767,324,271795,1011662,26,72,109240,2920646,5100,9417,251145,423,0,71,1,3,320,1
Alistipes_onderdonkii_55464,700024673,700105613,3036,1722611,304215,1127168,1301,719,40662,149849,1256,593,263553,977319,45,126,105074,2822098,4785,15594,433209,744,0,126,0,2,590,1
Alistipes_onderdonkii_55464,700024673,700106056,1934,1656555,290528,1082878,870,416,20055,75464,841,334,270473,1007414,29,82,109264,2907827,5151,8289,217761,342,0,82,0,0,333,1
Alistipes_onderdonkii_55464,700024673,700106876,1554,1729520,305311,1131759,697,334,19553,72743,666,262,285758,1059016,31,72,113311,3058541,5196,7849,209987,393,1,71,0,1,260,1
Alistipes_onderdonkii_55464,700024673,700107398,1291,1729364,305446,1131757,572,302,15936,60049,554,235,289510,1071708,18,67,114505,3095369,5250,6527,173290,330,0,67,0,0,234,1
Alistipes_onderdonkii_55464,700024673,700116505,3025,1726810,305096,1130082,1307,665,40225,149917,1268,545,264871,980165,39,120,104517,2831124,4854,16288,432761,702,0,120,0,1,543,1
Alistipes_onderdonkii_55464,700024673,700161742,2710,1707072,300924,1116350,1181,570,33840,127167,1157,481,267084,989183,24,89,106477,2856230,4842,13780,367019,702,1,88,0,0,480,1
Alistipes_onderdonkii_55464,700024673,700172221,2385,1719943,303103,1125077,1008,552,34730,129526,982,433,268373,995551,26,119,107083,2874695,4875,13904,373957,717,0,119,0,0,432,1
Alistipes_onderdonkii_55464,700024673,700172813,2980,1731789,305919,1133379,1259,683,38049,141611,1226,562,267870,991768,33,121,106071,2864397,4836,15101,408994,738,0,121,0,0,561,1
Alistipes_onderdonkii_55464,700024673,SRR2822459,2615,1730783,305648,1132621,1150,582,26996,99925,1114,449,278652,1032696,36,133,110440,2982584,5064,10699,288620,456,1,131,1,0,447,2
Alistipes_onderdonkii_55464,700024711,700033797,3966,1684282,295984,1101594,1700,810,43882,165031,1678,715,252102,936563,22,95,100719,2704350,4620,18003,476394,696,1,94,0,2,712,1
Alistipes_onderdonkii_55464,700024711,700037632,3951,1641128,286818,1073797,1652,857,42147,157303,1629,741,244671,916494,23,116,99375,2645508,4599,16982,454216,711,1,115,0,1,739,1
Alistipes_onderdonkii_55464,700024711,700038263,3389,1607883,279850,1051562,1386,752,36531,137603,1355,657,243319,913959,31,95,99686,2637589,4602,15120,397020,669,1,94,0,1,655,1
Alistipes_onderdonkii_55464,700024711,700099059,4651,1703954,300250,1114810,2015,980,51939,193588,1988,875,248311,921222,27,105,98540,2660614,4512,21057,558822,885,1,104,0,3,870,2
Alistipes_onderdonkii_55464,700024711,700103479,3317,1729135,304755,1131585,1402,762,39017,144431,1383,675,265738,987154,19,87,105785,2850802,4875,15507,417132,654,1,86,0,3,670,2
Alistipes_onderdonkii_55464,700024711,700111156,3087,1727931,304775,1130779,1271,703,33524,124458,1242,606,271251,1006321,29,97,107759,2906242,4962,13388,359431,555,1,96,0,1,604,1
Alistipes_onderdonkii_55464,700024711,700111296,3750,1718468,303096,1124584,1580,866,40223,149740,1564,782,262873,974844,16,84,104140,2815568,4824,16305,432240,675,1,81,2,3,778,1
Alistipes_onderdonkii_55464,700024711,700113975,2544,1723828,304135,1128099,1048,577,27381,101922,1008,489,276754,1026177,40,88,109780,2963630,5121,10997,294349,420,1,87,0,2,486,1
Alistipes_onderdonkii_55464,700024711,700116730,2519,1724312,304215,1128442,1063,582,27543,102163,1043,502,276672,1026279,20,80,109780,2963966,5091,11034,294993,462,2,78,0,1,500,1
Alistipes_onderdonkii_55464,700024711,700117938,4241,1657363,290623,1083497,1788,914,45915,171476,1758,793,244708,912021,30,121,99045,2632380,4638,18678,494961,789,1,119,1,2,790,1
Alistipes_onderdonkii_55464,700024711,700119739,3031,1723790,304215,1127981,1257,691,31689,117379,1228,607,272526,1010602,29,84,108065,2918773,4968,12698,338896,543,1,83,0,1,605,1
Alistipes_onderdonkii_55464,700024711,700120753,4235,1718514,303176,1124598,1743,998,41495,154717,1713,898,261681,969881,30,100,103626,2801241,4776,16796,446674,681,1,99,0,2,894,2
Alistipes_onderdonkii_55464,700024711,700163772,4785,1678311,295349,1097592,2074,996,57145,212655,2037,887,238204,884937,37,109,95547,2554764,4500,22829,614200,936,4,105,0,1,885,1
Alistipes_onderdonkii_55464,700024711,700164735,3597,1727261,304601,1130308,1513,801,37300,138587,1469,690,267301,991721,44,111,106058,2864272,4833,14950,400157,654,1,110,0,2,686,2
Alistipes_onderdonkii_55464,700024711,ERR911956,3513,1727419,304751,1130417,1467,781,37708,138774,1451,707,267043,991643,16,74,106337,2863666,4926,14759,400942,621,2,72,0,1,704,2
Alistipes_onderdonkii_55464,700024711,ERR911988,3670,1718994,303282,1124877,1557,836,39252,146061,1523,735,264030,978816,34,101,104965,2826620,4863,15501,422067,615,1,100,0,1,733,1
Alistipes_onderdonkii_55464,700024711,ERR911992,3443,1728347,304811,1131016,1405,784,38926,144329,1384,692,265885,986687,21,92,105594,2849532,4935,15582,416799,606,1,90,1,1,688,3
Alistipes_onderdonkii_55464,700024711,ERR912036,5336,1724187,304174,1128255,2262,1173,52585,195005,2219,1050,251589,933250,43,123,99841,2695214,4695,21006,563181,828,2,121,0,1,1047,2
Alistipes_onderdonkii_55464,700024711,ERR912037,3690,1730349,305205,1132328,1518,838,41186,152021,1476,712,264019,980307,42,126,105050,2830999,4872,16309,439097,657,1,125,0,1,709,2
Alistipes_onderdonkii_55464,700024711,ERR912076,2434,1731707,305373,1133273,1020,558,25393,95185,992,494,279980,1038088,28,64,111031,2998091,5142,10382,274753,420,1,63,0,2,491,1
Alistipes_onderdonkii_55464,700024711,ERR912078,4595,1725489,304293,1129140,1881,1079,48614,180231,1846,973,255679,948909,35,106,101649,2740389,4689,19390,520454,849,1,105,0,3,970,0
Alistipes_onderdonkii_55464,700024711,ERR912126,2502,1708873,301386,1118052,1052,568,25078,93360,1036,519,276308,1024692,16,49,109652,2959360,5064,10177,269456,447,2,47,0,0,517,2
Alistipes_onderdonkii_55464,700024711,mickey4-11-0-0_,3424,1718395,302705,1124537,1443,769,43339,160532,1413,678,259366,964005,30,91,103222,2784017,4776,17386,463466,744,2,89,0,1,677,0
Alistipes_onderdonkii_55464,700024711,pluto3-11-7-0_,3471,1709360,301290,1118703,1447,740,42471,158922,1420,637,258819,959781,27,103,102559,2772125,4659,17333,458665,768,2,101,0,1,636,0
Alistipes_onderdonkii_55464,700033153,700033726,2355,1697322,298471,1110598,972,554,31822,120505,911,440,266649,990093,61,114,106419,2859063,4797,12873,348153,489,0,114,0,1,437,2
Alistipes_onderdonkii_55464,700033153,700034254,2992,1675048,294213,1095470,1282,644,44443,166029,1210,520,249770,929441,72,124,100674,2683044,4605,17687,479677,723,0,124,0,3,516,1
Alistipes_onderdonkii_55464,700033153,700037501,3258,1693046,297652,1107816,1377,766,45865,171653,1338,650,251787,936163,39,116,100981,2702903,4605,18214,495962,783,0,116,0,2,647,1
Alistipes_onderdonkii_55464,700033153,700165167,2999,1695782,298408,1109600,1270,702,37474,140103,1201,567,260934,969497,69,135,104454,2799270,4767,14771,404944,594,0,134,1,1,564,2
Alistipes_onderdonkii_55464,700033726,700034254,2569,1682683,296010,1100717,1048,579,35287,131727,993,468,260723,968990,55,111,104464,2797751,4755,13999,380582,600,0,111,0,2,465,1
Alistipes_onderdonkii_55464,700033726,700037501,2541,1706094,300706,1116659,1025,653,26239,97166,996,524,274467,1019493,29,129,109209,2944227,5043,10330,280793,375,0,129,0,2,521,1
Alistipes_onderdonkii_55464,700033726,700117766,3706,1726377,304809,1130085,1529,892,42344,156736,1471,733,262465,973349,58,159,104027,2811280,4740,16569,452889,750,0,159,0,2,728,3
Alistipes_onderdonkii_55464,700033726,700165167,2214,1720944,303766,1126498,899,578,22490,83738,856,451,281276,1042760,43,127,111289,3011930,5061,8986,241835,393,0,126,1,0,449,2
Alistipes_onderdonkii_55464,700033726,ERR911971,3901,1728808,305105,1131653,1612,970,44536,166914,1580,855,260569,964739,32,115,102872,2786665,4680,17986,481994,762,0,115,0,4,850,1
Alistipes_onderdonkii_55464,700033726,ERR912024,2619,1736251,306362,1136565,1084,647,32775,121835,1021,514,273587,1014730,63,133,108604,2930624,4962,12744,352215,546,1,131,1,0,513,1
Alistipes_onderdonkii_55464,700033726,ERR912070,3813,1729178,305282,1131894,1604,872,42133,155348,1560,747,263149,976546,44,125,104529,2820312,4797,16307,449068,669,0,125,0,4,743,0
Alistipes_onderdonkii_55464,700033726,ERR912085,3766,1725495,304505,1129369,1559,877,39312,146035,1517,746,265193,983334,42,131,105200,2839945,4857,15466,422018,621,1,130,0,4,741,1
Alistipes_onderdonkii_55464,700033797,700037632,4161,1626563,283911,1063925,1804,843,44635,167077,1761,730,239276,896848,43,113,97599,2588415,4530,18019,482528,684,0,113,0,1,729,0
Alistipes_onderdonkii_55464,700033797,700038263,4271,1604316,279157,1049046,1854,862,42143,158849,1819,763,237014,890197,35,99,97249,2568941,4401,17392,458369,786,0,99,0,1,760,2
Alistipes_onderdonkii_55464,700033797,700099059,2287,1677606,294711,1097148,953,491,23836,89869,926,414,270875,1007279,27,77,108374,2908558,4905,9897,259338,372,1,76,0,2,411,1
Alistipes_onderdonkii_55464,700033797,700103479,3487,1696006,297952,1109424,1508,751,35996,133966,1485,665,261956,975458,23,86,105295,2816294,4785,14276,387049,573,0,86,0,3,661,1
Alistipes_onderdonkii_55464,700033797,700111156,3607,1693023,297665,1107453,1555,754,35756,133603,1511,635,261909,973850,44,119,104843,2811967,4740,14444,385774,591,0,119,0,1,634,0
Alistipes_onderdonkii_55464,700033797,700111296,4043,1683878,296036,1101492,1770,856,39835,149192,1746,768,256201,952300,24,88,102437,2749756,4707,16158,430800,618,0,87,1,2,766,0
Alistipes_onderdonkii_55464,700033797,700113975,3241,1688060,296873,1104213,1403,670,32978,124187,1370,582,263895,980026,33,88,105381,2829837,4860,13459,358619,483,0,88,0,2,580,0
Alistipes_onderdonkii_55464,700033797,700116730,2937,1689191,297072,1104946,1294,607,27979,104409,1267,510,269093,1000537,27,97,107721,2888973,4917,11215,301562,450,1,96,0,1,509,0
Alistipes_onderdonkii_55464,700033797,700117938,2127,1639550,286867,1071680,900,480,20270,75449,865,397,266597,996231,35,83,108686,2875015,4992,8118,217923,306,0,83,0,0,397,0
Alistipes_onderdonkii_55464,700033797,700119739,3452,1688903,297032,1104775,1472,737,32993,122919,1443,629,264039,981856,29,108,105712,2835053,4803,13234,354998,525,0,108,0,1,628,0
Alistipes_onderdonkii_55464,700033797,700120753,4541,1683983,296077,1101575,1928,1010,42470,158698,1900,908,253607,942877,28,102,101471,2722549,4611,17121,458319,654,0,102,0,2,905,1
Alistipes_onderdonkii_55464,700033797,700163772,2616,1656415,290675,1083028,1120,553,27933,104104,1090,477,262742,978924,30,76,106021,2825873,4878,11257,300614,441,1,75,0,1,476,0
Alistipes_onderdonkii_55464,700033797,700164735,3868,1693036,297585,1107492,1685,813,39497,148127,1641,692,258088,959365,44,121,103121,2770282,4692,16095,427662,624,0,121,0,2,689,1
Alistipes_onderdonkii_55464,700033797,ERR911956,3832,1692586,297687,1107146,1671,772,41048,151338,1655,697,256639,955808,16,75,103189,2759510,4725,16034,437344,636,0,75,0,1,695,1
Alistipes_onderdonkii_55464,700033797,ERR911988,3833,1683995,296164,1101484,1683,807,39626,147528,1651,695,256538,953956,32,112,102930,2754216,4722,15663,426354,567,0,112,0,1,694,0
Alistipes_onderdonkii_55464,700033797,ERR911992,3774,1693086,297715,1107394,1612,798,39151,145624,1584,691,258564,961770,28,107,103497,2777043,4770,15761,420520,591,0,106,1,1,689,1
Alistipes_onderdonkii_55464,700033797,ERR912037,3972,1695765,298173,1109213,1689,836,41853,155232,1653,722,256320,953981,36,114,102725,2754559,4659,16769,448258,669,0,114,0,1,720,1
Alistipes_onderdonkii_55464,700033797,ERR912076,2782,1696705,298283,1109859,1228,564,26986,101274,1206,494,271297,1008585,22,70,108547,2912243,4965,10993,292442,387,0,70,0,2,492,0
Alistipes_onderdonkii_55464,700033797,ERR912126,3101,1674403,294404,1095030,1364,626,31662,118588,1337,551,262742,976442,27,75,105062,2819479,4785,12900,342327,537,0,75,0,2,548,1
Alistipes_onderdonkii_55464,700033797,ERR912161,3446,1687268,296446,1103504,1476,754,42116,156342,1428,649,254330,947162,48,105,102245,2734642,4599,16836,451470,720,0,104,1,0,649,0
Alistipes_onderdonkii_55464,700033797,SRR413610,4114,1676546,295009,1096759,1751,851,47542,178234,1717,759,247467,918525,34,92,98516,2652808,4251,19402,514526,774,0,92,0,1,757,1
Alistipes_onderdonkii_55464,700033797,mickey4-11-0-0_,3871,1688525,296618,1104521,1688,790,45446,169511,1654,705,251172,935010,34,85,100630,2699840,4560,18403,489356,774,1,84,0,1,704,0
Alistipes_onderdonkii_55464,700033797,pluto3-11-7-0_,3782,1680036,295228,1099071,1619,754,44248,165398,1595,650,250980,933673,24,104,100418,2696056,4545,17929,477557,708,0,104,0,2,648,0
Alistipes_onderdonkii_55464,700034254,700037501,3398,1681191,295684,1099771,1402,784,48003,177697,1353,663,247681,922074,49,121,99801,2661780,4641,18743,513550,798,0,121,0,4,659,0
Alistipes_onderdonkii_55464,700035237,700165224,5089,1823581,322837,1193360,2140,1237,66003,241307,2132,1205,256834,952053,8,32,101680,2748944,5535,25633,697076,1212,1,31,0,4,1200,1
Alistipes_onderdonkii_55464,700035747,700106465,1927,1647985,288711,1077868,796,449,21371,80579,765,373,267340,997289,31,76,108112,2878754,5001,8728,232664,345,1,75,0,2,370,1
Alistipes_onderdonkii_55464,700035747,700163181,1986,1659409,290991,1085564,796,490,22717,85101,753,407,268274,1000463,43,83,108126,2888313,4950,9292,245612,399,0,83,0,3,404,0
Alistipes_onderdonkii_55464,700037042,700119562,2782,1738483,307139,1138060,1166,668,36924,136712,1147,590,270215,1001348,19,78,106909,2892122,5013,14466,395103,567,1,76,1,1,589,0
Alistipes_onderdonkii_55464,700037042,ERR912048,2998,1747993,308692,1144292,1302,689,33894,125470,1273,588,274798,1018822,29,101,108707,2942701,5058,13502,362344,564,1,100,0,3,583,2
Alistipes_onderdonkii_55464,700037042,ERR912143,2595,1745517,308284,1142529,1080,656,28668,105787,1047,579,279616,1036742,33,77,110755,2994272,5199,11357,305590,414,1,76,0,3,576,0
Alistipes_onderdonkii_55464,700037042,ERR912153,3405,1741043,307535,1139682,1479,754,42035,156430,1427,629,265500,983252,52,125,104904,2839947,4905,16957,451625,708,1,123,1,3,626,0
Alistipes_onderdonkii_55464,700037123,ERR911971,3858,1744717,308185,1142210,1668,836,40944,152257,1639,735,267241,989953,29,101,105657,2859285,4917,16296,439785,690,2,98,1,2,733,0
Alistipes_onderdonkii_55464,700037284,ERR912181,2919,1655086,290427,1082676,1231,690,39639,148206,1192,574,250788,934470,39,116,101343,2697222,4845,15789,428169,660,0,116,0,0,574,0
Alistipes_onderdonkii_55464,700037501,700165167,2222,1713338,302278,1121459,930,531,22480,83502,903,446,279798,1037957,27,85,111029,2997610,5232,9001,241160,345,0,84,1,2,443,1
Alistipes_onderdonkii_55464,700037632,700038263,2448,1578483,273734,1032386,1047,511,24858,93701,1006,405,248876,938685,41,106,103004,2708344,4707,10258,270365,480,0,106,0,0,403,2
Alistipes_onderdonkii_55464,700037632,700103479,3101,1652314,288636,1081363,1307,708,38943,144331,1281,608,249693,937032,26,100,101982,2704482,4632,15223,417071,699,0,100,0,2,605,1
Alistipes_onderdonkii_55464,700037632,700111156,3153,1652541,288823,1081536,1327,717,35074,130562,1287,602,253749,950974,40,115,103201,2745005,4716,14012,377086,588,0,115,0,0,602,0
Alistipes_onderdonkii_55464,700037632,700111296,3643,1639956,286701,1073209,1561,810,41373,153947,1534,714,245328,919262,27,96,99719,2653435,4632,16506,444639,696,0,95,1,2,712,0
Alistipes_onderdonkii_55464,700037632,700113975,2809,1642966,287294,1075199,1174,641,31530,117883,1126,530,255764,957316,48,111,103671,2763453,4824,12720,340425,504,0,111,0,1,529,0
Alistipes_onderdonkii_55464,700037632,700116730,2485,1645363,287703,1076794,1051,574,27796,102963,1021,475,259907,973831,30,99,105625,2810993,4875,10953,297456,480,1,98,0,0,475,0
Alistipes_onderdonkii_55464,700037632,700119739,3103,1644643,287616,1076282,1275,724,34406,128146,1240,615,253210,948136,35,109,102889,2736779,4740,13659,370185,594,0,109,0,0,615,0
Alistipes_onderdonkii_55464,700037632,700120753,2369,1641154,286970,1074020,968,561,24805,92535,923,456,262165,981485,45,105,106345,2833235,4875,9956,267253,396,0,105,0,1,454,1
Alistipes_onderdonkii_55464,700037632,700164735,3529,1649408,288263,1079438,1481,798,38895,144736,1421,666,249368,934702,60,132,101336,2698183,4587,15537,417960,711,0,132,0,1,664,1
Alistipes_onderdonkii_55464,700037632,700171115,3205,1637016,286007,1071213,1337,709,40055,149527,1293,587,245952,921686,44,122,99917,2660512,4629,16150,431750,681,2,120,0,2,584,1
Alistipes_onderdonkii_55464,700037632,ERR911956,3363,1648681,288264,1078924,1416,744,37220,137751,1386,656,251044,941173,30,88,102210,2716587,4722,14642,397987,624,0,88,0,0,655,1
Alistipes_onderdonkii_55464,700037632,ERR911988,3177,1643617,287378,1075610,1345,717,37930,141497,1306,598,249448,934113,39,119,101600,2696107,4632,14903,408931,657,0,119,0,0,598,0
Alistipes_onderdonkii_55464,700037632,ERR911992,3195,1649779,288422,1079587,1321,742,37817,140578,1281,633,250605,939009,40,109,101831,2710468,4728,15093,406011,630,0,108,1,0,632,1
Alistipes_onderdonkii_55464,700037632,ERR912036,3414,1648825,288221,1079005,1454,706,36290,135348,1406,576,251931,943657,48,130,102316,2723876,4779,14560,390929,555,1,129,0,0,575,1
Alistipes_onderdonkii_55464,700037632,ERR912037,3553,1654841,289218,1083034,1491,794,42831,159906,1450,681,246387,923128,41,113,100207,2664593,4584,17185,461798,735,0,113,0,0,680,1
Alistipes_onderdonkii_55464,700037632,ERR912076,2364,1655852,289374,1083710,999,536,27291,102105,959,444,262083,981605,40,92,106506,2833398,4911,10890,294975,450,0,92,0,1,443,0
Alistipes_onderdonkii_55464,700037632,ERR912078,3432,1651578,288646,1080892,1453,769,36321,135093,1408,648,252325,945799,45,121,102637,2730101,4659,14513,390091,675,0,121,0,1,646,1
Alistipes_onderdonkii_55464,700037632,ERR912126,2598,1633004,285407,1068491,1126,584,28741,107283,1094,495,256666,961208,32,89,104239,2774612,4773,11563,309764,522,1,88,0,0,494,1
Alistipes_onderdonkii_55464,700037632,ERR912188,4665,1656731,289493,1084347,1990,1002,49758,186533,1963,890,239735,897814,27,112,97170,2591805,4467,20331,538386,882,1,111,0,2,886,2
Alistipes_onderdonkii_55464,700037632,mickey4-11-0-0_,3527,1646430,287574,1077521,1489,790,40427,149814,1435,677,247147,927707,54,113,100672,2677844,4605,16096,432620,726,1,112,0,0,677,0
Alistipes_onderdonkii_55464,700037632,pluto3-11-7-0_,3254,1636731,285965,1071225,1348,702,42756,160379,1299,606,243209,910846,49,96,98542,2629526,4470,17508,462882,747,0,96,0,1,605,0
Alistipes_onderdonkii_55464,700038072,700107398,3585,1714699,302300,1122209,1532,831,43738,161825,1501,708,258562,960384,31,123,103145,2773210,4797,17167,467609,699,0,123,0,4,703,1
Alistipes_onderdonkii_55464,700038072,700161742,4306,1694373,298236,1108134,1869,940,51575,190440,1842,813,246661,917694,27,127,99376,2649095,4611,20228,550258,834,1,126,0,4,808,1
Alistipes_onderdonkii_55464,700038072,700172221,3961,1707173,300467,1116769,1691,913,46409,171778,1660,765,254058,944991,31,148,102030,2728122,4821,18265,496403,666,0,148,0,4,760,1
Alistipes_onderdonkii_55464,700038263,700099059,4405,1597281,277873,1044602,1945,870,41250,154997,1895,760,236623,889605,50,110,97112,2567296,4407,16981,447257,753,1,109,0,0,759,1
Alistipes_onderdonkii_55464,700038263,700103479,3119,1617292,281311,1057916,1353,673,31840,118938,1327,595,249471,938978,26,78,102680,2709607,4647,12880,343295,639,0,78,0,1,591,3
Alistipes_onderdonkii_55464,700038263,700111156,3229,1617133,281438,1057857,1365,711,32998,123487,1326,608,248440,934370,39,103,102212,2696257,4641,13310,356536,615,0,103,0,0,606,2
Alistipes_onderdonkii_55464,700038263,700111296,3630,1603412,279072,1048782,1565,780,34640,130184,1537,679,244432,918598,28,101,100212,2651001,4581,14235,375657,660,0,100,1,1,676,2
Alistipes_onderdonkii_55464,700038263,700113975,2805,1606929,279788,1051075,1162,631,28137,106427,1128,543,251651,944648,34,88,102982,2726222,4740,11662,307097,522,0,88,0,1,540,2
Alistipes_onderdonkii_55464,700038263,700116730,2602,1608666,280076,1052268,1116,575,24985,93231,1094,494,255091,959037,22,81,104667,2767683,4761,10123,269054,516,1,80,0,0,492,2
Alistipes_onderdonkii_55464,700038263,700119739,3065,1608104,280026,1051859,1277,701,28858,107897,1252,613,251168,943962,25,88,103050,2724159,4677,11722,311393,576,0,88,0,0,611,2
Alistipes_onderdonkii_55464,700038263,700120753,1468,1606168,279608,1050595,613,310,13215,50182,591,246,266393,1000413,22,64,109049,2887243,4947,5594,144682,270,0,64,0,0,245,1
Alistipes_onderdonkii_55464,700038263,700164735,3479,1613628,280856,1055460,1471,771,35598,133712,1435,669,245258,921748,36,102,100615,2660102,4527,14527,385889,720,0,102,0,1,665,3
Alistipes_onderdonkii_55464,700038263,700171115,2148,1603352,278942,1048633,950,431,24034,91101,912,361,254908,957532,38,70,104394,2763405,4797,10078,262757,468,2,68,0,1,359,1
Alistipes_onderdonkii_55464,700038263,ERR911956,3560,1614117,281032,1055777,1516,766,34798,129057,1494,699,246234,926720,22,67,101277,2674209,4674,13940,372601,630,0,67,0,0,696,3
Alistipes_onderdonkii_55464,700038263,ERR911972,4066,1615134,281023,1056470,1706,926,49152,184327,1678,838,231871,872143,28,88,95261,2516875,4293,20136,531858,987,0,88,0,3,834,1
Alistipes_onderdonkii_55464,700038263,ERR911988,3380,1608420,280007,1052054,1440,727,34408,129013,1403,636,245599,923041,37,91,101015,2663533,4575,13779,372606,654,0,91,0,0,634,2
Alistipes_onderdonkii_55464,700038263,ERR911992,3320,1614900,281114,1056266,1390,737,37590,139717,1368,655,243524,916549,22,82,100136,2644939,4572,15140,403300,711,0,81,1,0,652,3
Alistipes_onderdonkii_55464,700038263,ERR912033,3339,1614498,280995,1056106,1456,727,39040,146339,1416,619,241955,909767,40,108,99615,2625150,4536,15689,422599,729,0,108,0,0,618,1
Alistipes_onderdonkii_55464,700038263,ERR912036,2352,1614480,281044,1055979,1034,446,22491,84512,1003,362,258553,971467,31,84,106051,2803469,4881,9198,243936,402,1,83,0,0,361,1
Alistipes_onderdonkii_55464,700038263,ERR912037,3527,1620208,281992,1059791,1488,775,38521,144156,1462,689,243471,915635,26,86,99930,2642451,4524,15782,415945,741,0,86,0,0,686,3
Alistipes_onderdonkii_55464,700038263,ERR912061,2803,1610593,280347,1053413,1161,638,31622,119491,1123,527,248725,933922,38,111,102206,2694874,4686,12744,345123,606,1,110,0,0,527,0
Alistipes_onderdonkii_55464,700038263,ERR912076,2492,1620803,282017,1060250,1065,546,24753,92994,1046,489,257264,967256,19,57,105599,2791366,4803,10127,268369,486,1,56,0,0,487,2
Alistipes_onderdonkii_55464,700038263,ERR912078,1378,1618895,281740,1058977,583,322,15289,57073,553,260,266451,1001904,30,62,109535,2891158,5019,6103,164822,294,0,62,0,1,258,1
Alistipes_onderdonkii_55464,700038263,ERR912126,2825,1599164,278294,1045836,1224,609,29162,109667,1201,543,249132,936169,23,66,102168,2701689,4650,12009,316395,597,1,65,0,0,540,3
Alistipes_onderdonkii_55464,700038263,ERR912128,3026,1607547,279861,1051286,1332,665,33643,126186,1294,561,246218,925100,38,104,101087,2669557,4656,13797,364164,597,0,102,2,1,559,1
Alistipes_onderdonkii_55464,700038263,ERR912159,3556,1607038,279641,1051071,1568,706,42391,159772,1538,602,237250,891299,30,104,97123,2572343,4431,17702,460795,819,0,104,0,0,601,1
Alistipes_onderdonkii_55464,700038263,ERR912188,2970,1622936,282425,1061668,1247,646,31319,119038,1216,567,251106,942630,31,79,102678,2720490,4722,13206,343314,594,1,78,0,1,566,0
Alistipes_onderdonkii_55464,700038263,mickey4-11-0-0_,3554,1613821,280710,1055645,1506,779,42930,160581,1464,699,237780,895064,42,80,97692,2583087,4413,17559,463320,864,1,79,0,0,698,1
Alistipes_onderdonkii_55464,700038263,pluto3-11-7-0_,3329,1604084,279095,1049260,1388,690,39381,148322,1356,603,239714,900938,32,87,98174,2600158,4482,16356,427884,726,0,87,0,1,601,1
Alistipes_onderdonkii_55464,700038414,700095486,2767,1618801,283127,1058105,1182,651,36253,134808,1120,515,246874,923297,62,136,100970,2664172,4749,14380,389462,582,1,135,0,1,514,0
Alistipes_onderdonkii_55464,700038414,700097688,3119,1663861,292247,1088126,1274,744,41098,153615,1238,627,251149,934511,36,117,100911,2697975,4647,16613,443530,702,1,115,1,1,623,3
Alistipes_onderdonkii_55464,700038414,700101840,1809,1648041,288745,1077540,753,419,26122,98026,699,336,262623,979514,54,83,106469,2827045,5028,10491,283176,411,1,81,1,3,333,0
Alistipes_onderdonkii_55464,700038414,700105613,3159,1675235,294759,1095491,1346,725,44056,161441,1292,592,250703,934050,54,133,101425,2696021,4704,16795,466799,729,0,133,0,2,590,0
Alistipes_onderdonkii_55464,700038414,700106056,1943,1630159,285445,1065237,819,444,25201,94935,802,357,260244,970302,17,87,105812,2800093,5001,10316,274099,390,0,87,0,1,356,0
Alistipes_onderdonkii_55464,700038414,700106876,1876,1682791,296031,1100501,793,417,25003,92689,755,335,271028,1007812,38,82,108772,2909579,5085,9954,267720,393,1,81,0,1,334,0
Alistipes_onderdonkii_55464,700038414,700107398,1334,1680123,295700,1098817,546,320,17271,64506,517,259,278429,1034311,29,61,111605,2986117,5211,6889,186362,267,0,61,0,1,258,0
Alistipes_onderdonkii_55464,700038414,700116505,2920,1677829,295307,1097378,1248,654,43189,161099,1209,528,252118,936279,39,126,100890,2703195,4752,17401,465188,708,0,126,0,2,526,0
Alistipes_onderdonkii_55464,700038414,700161742,2790,1665892,292695,1088995,1197,595,33283,123859,1144,485,259412,965136,53,110,104833,2785724,4851,13251,357720,606,1,109,0,1,484,0
Alistipes_onderdonkii_55464,700038414,700172221,2520,1677131,294646,1096491,1061,568,36152,133601,1037,457,258494,962890,24,111,104471,2779339,4860,14222,385960,621,0,111,0,1,456,0
Alistipes_onderdonkii_55464,700038414,700172813,3052,1681918,296000,1100038,1287,689,41856,154806,1258,575,254144,945232,29,114,102237,2728713,4746,16349,447361,708,0,114,0,1,574,0
Alistipes_onderdonkii_55464,700038414,SRR2822459,2508,1683012,296078,1100759,1048,559,27130,100699,1003,437,268948,1000060,45,122,107904,2887248,5028,10771,290924,402,1,121,0,1,435,1
Alistipes_onderdonkii_55464,700095213,700101840,2856,1644223,288109,1075320,1243,641,39412,147438,1175,529,248697,927882,68,112,100592,2678401,4653,16020,425598,696,0,112,0,3,525,1
Alistipes_onderdonkii_55464,700095213,700106056,3141,1631168,285728,1066225,1347,707,38279,143249,1298,588,247449,922976,49,119,100491,2663781,4656,15509,413578,660,0,119,0,1,585,2
Alistipes_onderdonkii_55464,700095213,700106876,2822,1674007,294181,1095072,1222,625,37542,138942,1170,512,256639,956130,52,113,103130,2760559,4701,14948,401221,657,1,112,0,1,509,2
Alistipes_onderdonkii_55464,700095213,700107398,2632,1673786,294250,1094983,1124,600,35880,133462,1088,505,258370,961521,36,95,103671,2776152,4740,14336,385417,633,0,95,0,2,501,2
Alistipes_onderdonkii_55464,700095486,700101840,2449,1617070,282396,1057300,1057,586,32476,119938,1012,474,249920,937362,45,112,102646,2704586,4854,12643,346640,531,1,110,1,2,472,0
Alistipes_onderdonkii_55464,700095486,700106056,2492,1602131,279671,1046953,1093,578,31491,116566,1049,464,248180,930387,44,114,102130,2684174,4857,12428,336778,492,1,113,0,0,464,0
Alistipes_onderdonkii_55464,700095486,700106876,2316,1638411,286810,1071429,1012,547,29432,107741,963,426,257378,963688,49,121,104876,2781289,4899,11476,311252,495,2,119,0,0,426,0
Alistipes_onderdonkii_55464,700095486,700107398,1970,1636419,286592,1070151,848,484,26223,96337,806,368,260369,973814,42,116,106044,2810469,4929,10108,278459,444,1,115,0,0,368,0
Alistipes_onderdonkii_55464,700097688,700101840,2588,1659939,291031,1085943,1062,599,32683,122337,1009,505,258348,963606,53,94,104176,2781857,4785,13253,353173,585,1,92,1,2,501,2
Alistipes_onderdonkii_55464,700097688,700106056,2800,1643278,287990,1074307,1164,651,33461,125139,1124,553,254529,949168,40,98,103037,2739670,4797,13631,361228,558,1,96,1,0,550,3
Alistipes_onderdonkii_55464,700097688,700106876,2646,1696470,298497,1110260,1103,593,34370,126651,1052,499,264127,983609,51,94,105645,2840460,4722,13551,365760,642,2,91,1,1,495,3
Alistipes_onderdonkii_55464,700097688,700107398,2349,1697410,298757,1110949,959,566,29723,110734,925,472,269034,1000215,34,94,107357,2888452,4836,11834,319801,567,1,92,1,2,467,3
Alistipes_onderdonkii_55464,700097688,700161742,3481,1678934,295209,1098141,1448,794,41854,155019,1397,668,253355,943122,51,126,102096,2722683,4587,16448,447829,780,2,123,1,1,664,3
Alistipes_onderdonkii_55464,700097688,700172221,3198,1689576,297007,1105340,1306,765,38015,140712,1245,619,258992,964628,61,146,104172,2784996,4716,14969,406495,672,1,144,1,2,614,3
Alistipes_onderdonkii_55464,700099059,700103479,3838,1729472,304936,1131868,1676,824,42828,158768,1636,720,262108,973100,40,104,104384,2810176,4740,16792,458786,726,0,104,0,2,716,2
Alistipes_onderdonkii_55464,700099059,700111156,3958,1726738,304608,1130115,1726,845,43508,161683,1686,714,261100,968432,40,131,103636,2796995,4665,17330,466957,762,1,130,0,1,712,1
Alistipes_onderdonkii_55464,700099059,700113975,3651,1720748,303724,1126151,1602,786,39485,146328,1557,675,264239,979823,45,111,104817,2829876,4776,15582,422769,633,1,110,0,2,672,1
Alistipes_onderdonkii_55464,700099059,700116730,3346,1723978,304319,1128312,1485,710,35099,130508,1450,597,269220,997804,35,113,106645,2881892,4875,13991,376945,588,1,112,0,2,594,1
Alistipes_onderdonkii_55464,700099059,700117938,3088,1650448,289312,1078970,1309,681,32607,121691,1278,588,256705,957279,31,93,104046,2763015,4776,13206,351261,606,0,92,1,3,584,1
Alistipes_onderdonkii_55464,700099059,700119739,3847,1723156,304188,1127669,1663,828,42152,155547,1631,717,262036,972122,32,111,104022,2807643,4701,16577,449311,753,0,110,1,2,715,0
Alistipes_onderdonkii_55464,700099059,700120753,4333,1717383,303080,1123954,1902,914,45161,167936,1870,826,257919,956018,32,88,102168,2761308,4578,18025,484988,795,0,88,0,1,825,0
Alistipes_onderdonkii_55464,700099059,700163772,3654,1673734,294444,1094638,1531,813,43553,162541,1511,717,250891,932097,20,96,100549,2691125,4617,17499,469371,753,2,94,0,4,712,1
Alistipes_onderdonkii_55464,700099059,ERR911956,4109,1729002,305159,1131553,1818,843,46372,170021,1781,735,258787,961532,37,108,103188,2776662,4746,17841,491508,714,0,108,0,3,730,2
Alistipes_onderdonkii_55464,700099059,ERR911992,4001,1729124,305089,1131589,1738,860,47658,177479,1713,759,257431,954110,25,101,102006,2755632,4692,19066,512588,783,0,100,1,2,754,3
Alistipes_onderdonkii_55464,700099059,ERR912076,3212,1732883,305692,1134121,1420,672,35966,133620,1391,583,269726,1000501,29,89,107014,2889638,4851,14321,385927,612,1,88,0,2,580,1
Alistipes_onderdonkii_55464,700099059,ERR912126,3583,1707994,301317,1117582,1588,748,40648,151569,1553,662,260669,966013,35,86,103199,2790163,4677,16408,437561,738,1,85,0,2,658,2
Alistipes_onderdonkii_55464,700099886,700101581,891,1725322,302774,1128557,368,190,9063,34252,353,160,293711,1094305,15,30,118237,3158600,6078,3735,98838,183,1,29,0,1,159,0
Alistipes_onderdonkii_55464,700101840,700105613,2728,1673305,293625,1094751,1176,614,34772,128226,1126,486,258853,966525,50,128,104904,2789766,4905,13383,370746,549,0,127,1,4,482,0
Alistipes_onderdonkii_55464,700101840,700106056,1660,1629768,284962,1065349,736,359,21288,79878,703,292,263674,985471,33,67,107589,2843691,5133,8559,230760,315,0,66,1,2,290,0
Alistipes_onderdonkii_55464,700101840,700106876,1095,1692893,297041,1107749,498,221,15378,57365,465,174,281663,1050384,33,47,113377,3032567,5208,6253,165560,282,1,45,1,2,172,0
Alistipes_onderdonkii_55464,700101840,700107398,1004,1676307,294285,1096847,435,244,14098,52845,403,188,280187,1044002,32,56,112797,3013923,5286,5580,152730,225,0,55,1,3,185,0
Alistipes_onderdonkii_55464,700101840,700116505,2788,1672635,293686,1094445,1210,622,36931,137486,1169,519,256755,956959,41,103,103346,2762692,4839,14731,397085,642,0,102,1,4,515,0
Alistipes_onderdonkii_55464,700101840,700161742,2397,1664437,291720,1088469,1058,495,30143,112756,1022,410,261577,975713,36,85,106193,2816005,4941,11970,325776,522,1,83,1,3,407,0
Alistipes_onderdonkii_55464,700101840,700172221,2159,1677687,294066,1097327,916,497,24679,91721,875,388,269387,1005606,41,109,109268,2902432,5118,9627,265143,393,0,108,1,3,385,0
Alistipes_onderdonkii_55464,700101840,700172813,2680,1679324,294794,1098870,1128,619,34451,128513,1096,506,260343,970357,32,113,104990,2801173,4908,13588,371369,582,0,112,1,3,503,0
Alistipes_onderdonkii_55464,700101840,SRR2822459,2563,1681518,295090,1100268,1121,588,32538,120548,1067,451,262552,979720,54,137,106007,2828236,4917,12721,348395,528,1,134,2,3,447,1
Alistipes_onderdonkii_55464,700103479,700111156,2413,1754773,309788,1148752,1007,597,26899,98885,982,498,282889,1049867,25,99,112468,3031958,5175,10322,285907,426,0,99,0,2,495,1
Alistipes_onderdonkii_55464,700103479,700111296,2964,1744475,308001,1141995,1261,746,32026,117292,1245,659,275975,1024703,16,87,109744,2959313,5052,12281,339064,531,0,85,2,4,654,1
Alistipes_onderdonkii_55464,700103479,700113975,2101,1750139,309116,1145718,870,528,23138,85159,834,444,285978,1060559,36,84,113447,3063010,5220,8941,246164,372,0,84,0,3,440,1
Alistipes_onderdonkii_55464,700103479,700116730,1727,1750930,309273,1146245,744,443,20235,74092,729,369,289038,1072153,15,74,114737,3096427,5295,7709,214222,345,1,73,0,2,366,1
Alistipes_onderdonkii_55464,700103479,700117938,3538,1670534,292882,1092339,1494,821,36966,136524,1458,699,255916,955815,36,122,104308,2758325,4812,14379,394515,678,0,121,1,2,696,1
Alistipes_onderdonkii_55464,700103479,700119739,2318,1749631,309085,1145316,944,579,24325,89007,918,499,284760,1056309,26,80,112974,3050787,5166,9396,257205,420,0,80,0,2,496,1
Alistipes_onderdonkii_55464,700103479,700120753,3315,1745434,308282,1142596,1378,816,33568,123481,1353,710,274714,1019115,25,106,109031,2943295,5019,13033,356864,546,0,106,0,1,707,2
Alistipes_onderdonkii_55464,700103479,700163772,4001,1694628,298213,1108583,1729,880,42563,156714,1684,767,255650,951869,45,113,102996,2747826,4785,16488,452931,723,2,111,0,3,763,1
Alistipes_onderdonkii_55464,700103479,700164735,2757,1755383,309846,1149117,1171,665,31298,115460,1124,553,278548,1033657,47,112,110470,2985476,5025,12285,333549,546,0,112,0,1,552,0
Alistipes_onderdonkii_55464,700103479,700171115,4218,1736760,306387,1136773,1766,966,49566,183321,1731,866,256821,953452,35,100,102112,2753555,4689,19475,529621,867,2,98,0,3,861,2
Alistipes_onderdonkii_55464,700103479,ERR911956,2683,1757782,310497,1150636,1128,626,30425,110631,1118,563,280072,1040005,10,63,111497,3003355,5163,11476,319940,477,0,63,0,3,558,2
Alistipes_onderdonkii_55464,700103479,ERR911988,2713,1748704,308897,1144673,1147,686,30727,113142,1122,568,278170,1031531,25,118,110545,2978930,5118,11783,327175,468,0,118,0,2,565,1
Alistipes_onderdonkii_55464,700103479,ERR911992,2639,1757843,310463,1150621,1091,650,31018,113810,1066,564,279445,1036811,25,86,110905,2994353,5175,12045,328914,471,0,85,1,2,559,3
Alistipes_onderdonkii_55464,700103479,ERR912036,4205,1754077,309811,1148161,1806,946,42931,158551,1779,837,266880,989610,27,109,105968,2857891,4971,16740,458268,645,1,108,0,2,833,2
Alistipes_onderdonkii_55464,700103479,ERR912037,2754,1760050,310814,1152113,1127,692,33080,121315,1097,592,277734,1030798,30,100,110438,2976871,5085,12736,350675,534,0,100,0,2,588,2
Alistipes_onderdonkii_55464,700103479,ERR912076,1613,1761743,311043,1153296,675,416,20014,73897,658,359,291029,1079399,17,57,115445,3117442,5310,7815,213558,318,0,57,0,3,355,1
Alistipes_onderdonkii_55464,700103479,ERR912078,4274,1754305,309735,1148404,1809,1014,45103,165203,1793,921,264632,983201,16,93,105403,2839379,4821,17396,477424,789,0,93,0,4,915,2
Alistipes_onderdonkii_55464,700103479,ERR912126,1954,1737233,306728,1136962,844,466,21897,80276,820,396,284831,1056686,24,70,113123,3051736,5199,8461,231974,393,1,69,0,2,392,2
Alistipes_onderdonkii_55464,700103479,mickey4-11-0-0_,2947,1742539,307179,1140687,1246,709,39020,142557,1217,605,268159,998130,29,104,107088,2882409,4893,14963,412057,651,1,103,0,2,602,1
Alistipes_onderdonkii_55464,700103479,pluto3-11-7-0_,2896,1733425,305790,1134801,1203,656,37566,138797,1174,549,268224,996004,29,107,106480,2876648,4884,14861,400939,591,0,107,0,3,545,1
Alistipes_onderdonkii_55464,700105613,700106056,2867,1645059,288459,1075356,1237,657,37837,139963,1199,539,250622,935393,38,118,101997,2699367,4815,14803,404498,588,0,118,0,1,538,0
Alistipes_onderdonkii_55464,700105613,700106876,2665,1731119,305593,1133089,1146,620,33550,122335,1088,487,272043,1010754,58,133,108592,2918639,5031,12626,353860,519,1,132,0,3,484,0
Alistipes_onderdonkii_55464,700105613,700107398,2450,1728179,305365,1131178,1047,577,32109,117354,1011,467,273256,1013824,36,110,108704,2927734,5034,12144,339411,507,0,110,0,2,465,0
Alistipes_onderdonkii_55464,700105613,700116505,2732,1730976,305884,1133046,1171,625,37321,136923,1136,511,268563,996123,35,114,106570,2876852,4947,14405,395764,600,0,114,0,1,510,0
Alistipes_onderdonkii_55464,700105613,700161742,2345,1701426,299846,1112775,1010,506,25350,93417,969,408,274496,1019358,41,98,110172,2942790,5112,9711,270147,393,1,97,0,1,407,0
Alistipes_onderdonkii_55464,700105613,700172221,1961,1716542,302499,1122914,831,436,23978,87743,801,355,278521,1035171,30,81,111777,2988528,5208,8944,253916,369,0,81,0,1,354,0
Alistipes_onderdonkii_55464,700105613,700172813,2561,1736201,306767,1136520,1071,602,36407,133052,1051,492,270360,1003468,20,110,107592,2897802,5010,13770,384849,537,0,110,0,2,490,0
Alistipes_onderdonkii_55464,700106056,700106876,1461,1654047,290016,1081315,636,312,15751,58271,610,249,274265,1023044,26,63,111114,2952795,5223,6308,168265,240,1,62,0,0,249,0
Alistipes_onderdonkii_55464,700106056,700107398,1127,1650254,289437,1078921,475,266,11261,42284,449,200,278176,1036637,26,66,112532,2992033,5346,4581,122148,123,0,66,0,0,200,0
Alistipes_onderdonkii_55464,700106056,700116505,2948,1645858,288727,1076040,1270,646,37556,139195,1232,527,251171,936845,38,119,101705,2703964,4866,15063,401967,555,0,119,0,1,526,0
Alistipes_onderdonkii_55464,700106056,700161742,2626,1641176,287518,1072564,1144,552,30988,115059,1116,467,256530,957505,28,85,104620,2762993,4902,12296,332338,543,1,84,0,0,467,0
Alistipes_onderdonkii_55464,700106056,700172221,2385,1649776,288998,1078306,1005,550,28273,105097,981,452,260725,973209,24,98,106242,2808366,5019,11169,303681,441,0,98,0,0,452,0
Alistipes_onderdonkii_55464,700106056,700172813,2860,1651047,289568,1079485,1204,656,33844,125583,1183,539,255724,953902,21,117,103695,2753115,4896,13456,362747,546,0,117,0,0,539,0
Alistipes_onderdonkii_55464,700106056,SRR2822459,2803,1650953,289485,1079386,1223,640,31930,118548,1186,508,257555,960838,37,132,104289,2773353,4872,12837,342285,522,1,130,1,0,507,1
Alistipes_onderdonkii_55464,700106465,700163181,2944,1712552,301398,1120488,1227,675,36240,134625,1193,566,265158,985863,34,109,106155,2846574,4860,14455,388766,654,1,108,0,1,564,1
Alistipes_onderdonkii_55464,700106876,700107398,834,1734757,306378,1135610,367,188,9542,35017,338,136,296836,1100593,29,52,117641,3178738,5400,3727,101138,186,1,51,0,1,135,0
Alistipes_onderdonkii_55464,700106876,700116505,2823,1732024,305951,1133840,1214,629,36957,136173,1174,519,268994,997667,40,110,106524,2881545,4932,14577,393306,636,0,110,0,3,516,0
Alistipes_onderdonkii_55464,700106876,700161742,2321,1707248,300734,1116701,1012,480,26926,99748,977,389,273808,1016953,35,91,109734,2936073,5052,10565,288178,501,2,89,0,1,388,0
Alistipes_onderdonkii_55464,700106876,700172221,2077,1723111,303484,1127413,875,478,23464,86434,841,364,280020,1040979,34,114,112134,3005601,5202,9116,249781,405,1,113,0,1,363,0
Alistipes_onderdonkii_55464,700106876,700172813,2697,1739058,307177,1138493,1133,628,35309,130687,1115,521,271868,1007806,18,107,107679,2910792,4947,13894,377522,645,1,106,0,1,520,0
Alistipes_onderdonkii_55464,700106876,SRR2822459,2717,1738954,306980,1138378,1201,616,32975,120845,1165,488,274005,1017533,36,128,108783,2938869,4947,12838,349112,585,2,125,1,1,486,1
Alistipes_onderdonkii_55464,700107398,700116505,2417,1735632,306838,1136239,1020,560,34878,128690,988,461,271960,1007549,32,99,107494,2910134,5019,13732,371780,558,0,99,0,1,460,0
Alistipes_onderdonkii_55464,700107398,700161742,2010,1703408,300315,1114200,858,440,24112,89799,834,358,276203,1024401,24,82,110347,2957780,5076,9575,259375,447,1,81,0,0,358,0
Alistipes_onderdonkii_55464,700107398,700165778,3685,1737438,307205,1137411,1578,862,44217,163007,1541,723,262988,974404,37,139,104167,2814191,4854,17145,471183,693,0,138,1,4,719,0
Alistipes_onderdonkii_55464,700107398,700172221,1694,1717972,302881,1124032,695,410,20561,75517,669,326,282320,1048515,26,84,112903,3027392,5250,7837,218378,336,0,84,0,0,326,0
Alistipes_onderdonkii_55464,700107398,700172813,2340,1739911,307539,1139041,962,570,31392,116457,941,470,276147,1022584,21,100,109257,2953449,5046,12270,336549,552,0,100,0,0,470,0
Alistipes_onderdonkii_55464,700107398,SRR2822459,2185,1736225,306806,1136584,949,525,24043,88132,912,398,282763,1048452,37,127,111938,3028270,5148,9348,254646,402,1,125,1,0,397,1
Alistipes_onderdonkii_55464,700111156,700111296,2854,1742104,307779,1140430,1200,695,30206,111650,1176,595,277573,1028780,24,100,109913,2971345,5082,11858,322594,498,0,98,2,2,593,0
Alistipes_onderdonkii_55464,700111156,700113975,2046,1748726,309087,1144788,847,498,23635,88568,813,405,285452,1056220,34,93,112700,3050731,5229,9471,255879,354,0,93,0,1,404,0
Alistipes_onderdonkii_55464,700111156,700116730,1296,1750646,309441,1146130,542,295,13561,50688,523,221,295880,1095442,19,74,116864,3164041,5421,5419,146447,198,1,73,0,0,221,0
Alistipes_onderdonkii_55464,700111156,700117938,3542,1667426,292540,1090271,1502,790,41039,152177,1474,673,251501,938094,28,117,102174,2707341,4767,16230,439599,702,0,116,1,2,671,0
Alistipes_onderdonkii_55464,700111156,700119739,2182,1750209,309379,1145753,879,527,25314,93945,855,446,284065,1051808,24,81,112237,3037994,5193,10038,271389,408,0,81,0,0,446,0
Alistipes_onderdonkii_55464,700111156,700120753,3273,1743246,308080,1141199,1354,800,34104,126370,1320,694,273976,1014829,34,106,108263,2931244,4980,13562,364984,564,0,106,0,1,692,1
Alistipes_onderdonkii_55464,700111156,700164735,2741,1752682,309589,1147375,1149,633,31753,118074,1100,517,277836,1029301,49,116,109960,2972927,5016,12536,341161,525,0,116,0,1,515,1
Alistipes_onderdonkii_55464,700111156,ERR911956,2568,1755345,310277,1149114,1081,598,29112,105746,1053,523,281165,1043368,28,75,111762,3013137,5205,10944,305862,432,0,75,0,1,521,1
Alistipes_onderdonkii_55464,700111156,ERR911988,2637,1749684,309246,1145397,1115,628,31007,114815,1095,524,278239,1030582,20,104,110361,2976276,5109,11918,332074,453,0,104,0,0,524,0
Alistipes_onderdonkii_55464,700111156,ERR911992,2389,1755911,310300,1149421,992,559,27445,100979,960,467,282855,1048442,32,92,111952,3028142,5232,10770,291786,381,0,91,1,0,465,2
Alistipes_onderdonkii_55464,700111156,ERR912036,4264,1752797,309819,1147397,1843,915,46646,172666,1817,808,263173,974731,26,107,104180,2815087,4926,18344,498973,681,1,106,0,0,807,1
Alistipes_onderdonkii_55464,700111156,ERR912037,2651,1761273,311237,1153006,1106,625,36827,135913,1082,530,274410,1017093,24,95,108769,2937542,4968,14401,392702,636,0,95,0,0,529,1
Alistipes_onderdonkii_55464,700111156,ERR912076,1477,1763075,311480,1154243,599,368,15385,56734,574,295,296095,1097509,25,73,117289,3169847,5391,5956,164015,231,1,72,0,0,295,0
Alistipes_onderdonkii_55464,700111156,ERR912078,4286,1755969,310173,1149552,1803,1013,43430,159865,1762,898,266743,989687,41,115,105917,2858314,4830,16910,461926,759,0,115,0,2,895,1
Alistipes_onderdonkii_55464,700111156,ERR912126,1944,1738516,307149,1137889,801,452,20709,76712,769,380,286440,1061177,32,72,113351,3064972,5208,8234,221542,360,1,71,0,0,379,1
Alistipes_onderdonkii_55464,700111156,mickey4-11-0-0_,2586,1740472,306998,1139420,1078,580,32959,121513,1041,484,274039,1017907,37,96,108949,2939789,4983,12934,351047,558,1,95,0,0,484,0
Alistipes_onderdonkii_55464,700111156,pluto3-11-7-0_,2781,1730911,305505,1133202,1152,604,33750,125290,1120,499,271755,1007912,32,105,107649,2911185,4902,13447,361856,567,0,105,0,1,498,0
Alistipes_onderdonkii_55464,700111296,700113975,2754,1741300,307784,1139903,1157,685,27303,101350,1126,595,280481,1038553,31,90,110825,2999695,5139,10772,292831,447,0,88,2,3,592,0
Alistipes_onderdonkii_55464,700111296,700116730,2324,1742515,308014,1140730,1010,568,23287,85894,995,495,284727,1054836,15,73,112585,3046685,5238,9107,248182,393,1,70,2,2,493,0
Alistipes_onderdonkii_55464,700111296,700117938,3996,1658859,291086,1084640,1747,865,43452,161063,1735,766,247634,923577,12,99,100425,2665626,4680,17277,465162,750,0,98,1,3,763,0
Alistipes_onderdonkii_55464,700111296,700119739,2914,1740758,307755,1139498,1209,713,28460,104903,1185,623,279295,1034595,24,90,110376,2988330,5079,11205,303006,498,0,88,2,2,621,0
Alistipes_onderdonkii_55464,700111296,700120753,3917,1735799,306807,1136271,1630,953,37178,137428,1591,846,269629,998843,39,107,106568,2885047,4914,14682,396990,612,0,105,2,3,842,1
Alistipes_onderdonkii_55464,700111296,700164735,3392,1741697,307689,1140125,1456,797,35843,132650,1413,697,271846,1007475,43,100,107600,2909902,4923,14097,383238,615,0,98,2,3,693,1
Alistipes_onderdonkii_55464,700111296,ERR911956,3289,1742762,308117,1140780,1390,781,33205,121356,1372,710,274912,1019424,18,71,108967,2944196,5109,12790,350762,516,0,69,2,3,706,1
Alistipes_onderdonkii_55464,700111296,ERR911988,3247,1734572,306651,1135420,1402,786,36004,133407,1371,682,270647,1002013,31,104,107178,2893893,4968,13976,385666,579,0,103,1,2,679,1
Alistipes_onderdonkii_55464,700111296,ERR911992,3113,1743703,308213,1141354,1296,734,33413,123267,1271,639,274800,1018087,25,95,108718,2940461,5082,13124,356149,528,0,95,0,2,636,1
Alistipes_onderdonkii_55464,700111296,ERR912036,4881,1740394,307667,1139194,2113,1086,47167,174282,2082,964,260500,964912,31,122,103029,2786850,4857,18581,503530,735,1,119,2,2,961,1
Alistipes_onderdonkii_55464,700111296,ERR912037,3345,1745782,308537,1142774,1402,799,38872,143221,1366,691,269665,999553,36,108,106752,2886945,4962,15292,413750,621,0,106,2,2,688,1
Alistipes_onderdonkii_55464,700111296,ERR912076,2120,1747410,308810,1143881,918,505,21300,78639,898,447,287510,1065242,20,58,113761,3076682,5283,8354,227236,327,1,55,2,2,445,0
Alistipes_onderdonkii_55464,700111296,ERR912078,4909,1740646,307583,1139407,2090,1158,49286,181026,2062,1046,258297,958381,28,112,102521,2767888,4734,19185,523038,855,0,110,2,4,1041,1
Alistipes_onderdonkii_55464,700111296,ERR912126,2667,1722415,304392,1127219,1143,639,26140,96856,1124,575,278252,1030363,19,64,109983,2976000,5106,10424,279703,441,1,61,2,2,572,1
Alistipes_onderdonkii_55464,700111296,mickey4-11-0-0_,3431,1728932,305053,1131737,1470,805,38705,142161,1438,703,266348,989576,32,102,105806,2858083,4839,15213,410595,675,1,100,1,1,702,0
Alistipes_onderdonkii_55464,700111296,pluto3-11-7-0_,3309,1720194,303668,1126102,1397,730,36827,136459,1371,635,266841,989643,26,95,105659,2858422,4848,14665,394109,603,0,94,1,2,633,0
Alistipes_onderdonkii_55464,700113975,700116730,1350,1749211,309311,1145156,566,345,13292,49654,537,270,296019,1095502,29,75,116908,3164177,5421,5214,143556,192,1,74,0,1,269,0
Alistipes_onderdonkii_55464,700113975,700117938,3332,1661731,291634,1086536,1412,758,33552,125144,1373,640,258082,961392,39,118,104547,2774760,4869,13350,361509,573,0,117,1,2,638,0
Alistipes_onderdonkii_55464,700113975,700119739,1886,1747936,309139,1144248,752,468,19830,73939,720,388,289309,1070309,32,80,114102,3091566,5259,7903,213581,333,0,80,0,1,387,0
Alistipes_onderdonkii_55464,700113975,700120753,3084,1744620,308481,1142112,1256,776,29797,110890,1218,681,278684,1031222,38,95,109853,2978749,5064,11944,320243,483,0,95,0,2,678,1
Alistipes_onderdonkii_55464,700113975,700163772,3885,1687367,297168,1103832,1685,840,40374,150061,1630,710,256794,953771,55,130,102875,2753608,4830,15989,433555,639,2,128,0,2,708,0
Alistipes_onderdonkii_55464,700113975,700164735,2469,1750261,309269,1145786,1025,588,25271,94218,968,484,283998,1051568,57,104,112184,3037387,5133,10050,272187,417,0,104,0,2,481,1
Alistipes_onderdonkii_55464,700113975,700171115,3875,1730350,305623,1132588,1596,892,45249,168448,1550,790,260374,964140,46,102,102940,2784740,4740,18000,486555,789,2,100,0,4,785,1
Alistipes_onderdonkii_55464,700113975,ERR911956,2291,1749206,309314,1145090,972,525,27703,100892,947,466,281611,1044198,25,59,111748,3015644,5202,10389,291864,423,0,59,0,2,463,1
Alistipes_onderdonkii_55464,700113975,ERR911988,2397,1740790,307841,1139518,1009,588,26307,98651,967,488,281534,1040867,42,100,111162,3006285,5154,10374,285177,402,0,100,0,1,487,0
Alistipes_onderdonkii_55464,700113975,ERR911992,2311,1748746,309163,1144731,929,565,25595,94712,897,488,283568,1050019,32,77,112125,3032679,5253,10025,273757,354,0,76,1,1,485,2
Alistipes_onderdonkii_55464,700113975,ERR912036,4098,1744567,308497,1141978,1734,920,42343,157373,1701,812,266154,984605,33,108,105041,2843845,4929,16805,454684,630,1,107,0,1,810,1
Alistipes_onderdonkii_55464,700113975,ERR912037,2536,1750504,309460,1145910,1035,611,32695,121448,999,509,276765,1024462,36,102,109394,2958952,5040,12904,350906,534,0,102,0,1,507,1
Alistipes_onderdonkii_55464,700113975,ERR912076,1222,1752462,309753,1147244,493,318,14105,52962,468,271,295648,1094282,25,47,116780,3160636,5430,5606,153094,186,0,47,0,2,269,0
Alistipes_onderdonkii_55464,700113975,ERR912078,3978,1745072,308428,1142353,1634,967,42582,156608,1599,879,265846,985745,35,88,105410,2847013,4812,16547,452509,768,0,88,0,3,875,1
Alistipes_onderdonkii_55464,700113975,ERR912126,1682,1727730,305373,1130787,704,389,17484,65622,671,327,287889,1065165,33,62,113671,3076583,5241,7080,189471,315,1,61,0,1,325,1
Alistipes_onderdonkii_55464,700113975,ERR912128,4607,1735646,306789,1135998,1964,1085,51751,191114,1924,962,255038,944884,40,123,101091,2728860,4701,20290,552227,825,1,120,2,2,959,1
Alistipes_onderdonkii_55464,700113975,ERR912188,5219,1750742,309462,1146146,2205,1179,55897,207235,2184,1080,253565,938911,21,99,100043,2712070,4620,22252,598484,969,1,98,0,3,1075,2
Alistipes_onderdonkii_55464,700113975,mickey4-11-0-0_,2536,1731768,305600,1133628,1055,598,31536,116430,1010,515,274064,1017198,45,83,108857,2937775,4962,12308,336427,555,1,82,0,1,514,0
Alistipes_onderdonkii_55464,700113975,pluto3-11-7-0_,2442,1724494,304544,1128977,989,544,29973,112823,950,450,274571,1016154,39,94,108336,2935173,4953,12208,325766,495,0,94,0,2,448,0
Alistipes_onderdonkii_55464,700116505,700161742,1760,1703480,300359,1114226,746,374,20738,77673,717,307,279621,1036553,29,67,111455,2993047,5157,8422,224237,360,1,66,0,1,306,0
Alistipes_onderdonkii_55464,700116505,700172221,1679,1717367,302834,1123608,678,418,19921,74008,646,332,282913,1049600,32,86,112685,3030847,5268,7936,213785,303,0,86,0,1,331,0
Alistipes_onderdonkii_55464,700116505,700172813,1904,1743188,308227,1141207,774,452,23173,85641,749,363,285054,1055566,25,89,112474,3048977,5247,9163,247400,360,0,89,0,1,362,0
Alistipes_onderdonkii_55464,700116730,700117938,3018,1662809,291813,1087278,1305,673,31274,115693,1287,562,260539,971585,18,111,105721,2804084,4950,12272,334261,546,1,109,1,1,561,0
Alistipes_onderdonkii_55464,700116730,700119739,1516,1749315,309363,1145208,617,375,14767,54089,601,299,294596,1091119,16,76,116455,3151520,5382,5673,156315,279,1,75,0,0,299,0
Alistipes_onderdonkii_55464,700116730,700120753,2701,1743945,308387,1141698,1108,680,24486,90281,1065,589,283901,1051417,43,91,112192,3036887,5172,9614,260806,423,1,90,0,1,587,1
Alistipes_onderdonkii_55464,700116730,700163772,3543,1688079,297324,1104307,1547,767,36733,135602,1517,659,260591,968705,30,108,104589,2796615,4911,14313,391869,624,3,105,0,1,658,0
Alistipes_onderdonkii_55464,700116730,700164735,2126,1749368,309116,1145223,911,509,23497,87245,869,419,285619,1057978,42,90,112924,3055841,5169,9279,252042,414,1,89,0,1,417,1
Alistipes_onderdonkii_55464,700116730,700171115,3565,1731883,305923,1133626,1493,833,40782,151101,1458,739,265141,982525,35,94,104895,2837799,4881,16157,436438,708,2,92,0,4,734,1
Alistipes_onderdonkii_55464,700116730,ERR911956,2074,1750804,309615,1146139,886,472,22354,80789,872,424,287261,1065350,14,48,113972,3076741,5337,8307,233721,339,1,47,0,1,422,1
Alistipes_onderdonkii_55464,700116730,ERR911988,1982,1742486,308159,1140649,865,481,23255,86195,844,385,284904,1054454,21,96,112744,3045395,5223,8901,249294,390,1,95,0,0,385,0
Alistipes_onderdonkii_55464,700116730,ERR911992,1872,1751399,309681,1146492,774,445,19485,71693,747,370,290196,1074799,27,75,114755,3104275,5367,7574,207211,294,1,73,1,0,368,2
Alistipes_onderdonkii_55464,700116730,ERR912033,4498,1745157,308595,1142456,1921,1061,54077,199275,1882,931,254518,943181,39,130,101125,2723774,4644,20811,576036,978,1,129,0,1,929,1
Alistipes_onderdonkii_55464,700116730,ERR912036,3676,1748284,309171,1144446,1590,799,36395,134533,1554,697,272776,1009913,36,102,107849,2916769,5121,14267,388789,543,2,100,0,0,696,1
Alistipes_onderdonkii_55464,700116730,ERR912037,2114,1752984,309934,1147565,886,495,24782,91022,851,403,285152,1056543,35,92,112887,3051528,5214,9582,263055,429,1,91,0,0,402,1
Alistipes_onderdonkii_55464,700116730,ERR912076,790,1755251,310264,1149110,334,205,8530,31815,321,160,301734,1117295,13,45,119238,3227094,5553,3351,91977,117,1,44,0,1,159,0
Alistipes_onderdonkii_55464,700116730,ERR912078,3690,1748372,309031,1144577,1555,888,37796,138560,1531,800,271235,1006017,24,88,107566,2905538,4947,14587,400412,681,1,87,0,2,797,1
Alistipes_onderdonkii_55464,700116730,ERR912126,1335,1729507,305720,1131973,585,321,14343,52905,566,269,291377,1079068,19,52,115184,3116683,5337,5674,152771,270,2,50,0,0,268,1
Alistipes_onderdonkii_55464,700116730,ERR912128,4339,1738009,307272,1137557,1865,1026,48923,179742,1842,913,258349,957815,23,113,102540,2766099,4806,19021,519425,780,1,110,2,2,910,1
Alistipes_onderdonkii_55464,700116730,ERR912188,5004,1753672,309994,1148130,2137,1128,54441,200775,2124,1026,255553,947355,13,102,101153,2736238,4674,21349,580007,969,1,101,0,3,1021,2
Alistipes_onderdonkii_55464,700116730,mickey4-11-0-0_,1891,1734855,306170,1135730,805,435,22511,82560,768,355,283659,1053170,37,80,112647,3041694,5169,8743,238553,384,2,78,0,0,355,0
Alistipes_onderdonkii_55464,700116730,pluto3-11-7-0_,2139,1726372,304862,1130249,894,471,25967,96649,863,383,278895,1033600,31,88,110214,2985513,5073,10475,279055,417,1,87,0,1,382,0
Alistipes_onderdonkii_55464,700117766,ERR912085,4281,1739565,307501,1138668,1792,1022,49390,183938,1752,892,258111,954730,40,130,101961,2757462,4767,19545,531378,891,1,129,0,6,884,2
Alistipes_onderdonkii_55464,700117938,700119739,3486,1662612,291885,1087060,1456,793,34196,126606,1427,665,257689,960454,29,128,104403,2772147,4812,13569,365610,639,0,127,1,1,664,0
Alistipes_onderdonkii_55464,700117938,700120753,4273,1658438,291030,1084335,1805,952,42616,157809,1775,840,248414,926526,30,112,100870,2674052,4656,16819,455849,759,0,111,1,2,837,1
Alistipes_onderdonkii_55464,700117938,700163772,2952,1644888,288292,1075195,1248,674,33371,123213,1216,582,254921,951982,32,92,104039,2746969,4938,13048,356051,540,1,90,1,1,581,0
Alistipes_onderdonkii_55464,700117938,700164735,3875,1666806,292416,1089835,1671,868,43804,163328,1632,739,248612,926507,39,129,100704,2674161,4656,17564,471637,783,0,128,1,1,737,1
Alistipes_onderdonkii_55464,700117938,ERR911956,3855,1667227,292576,1090100,1654,827,42079,154208,1625,724,250497,935892,29,103,102075,2700822,4779,16303,445601,720,0,102,1,3,720,1
Alistipes_onderdonkii_55464,700117938,ERR911988,3790,1657893,290954,1083956,1631,841,40144,149515,1588,705,250810,934441,43,136,101768,2696776,4779,15921,431955,669,0,135,1,1,704,0
Alistipes_onderdonkii_55464,700117938,ERR911992,3708,1668127,292662,1090644,1553,822,43562,161821,1528,714,249100,928823,25,108,100955,2680801,4713,17483,467209,771,0,107,1,2,711,1
Alistipes_onderdonkii_55464,700117938,ERR912076,2764,1670678,293078,1092405,1193,616,30852,114656,1168,530,262226,977749,25,86,106391,2821867,4989,12246,331209,513,0,85,1,2,528,0
Alistipes_onderdonkii_55464,700117938,ERR912126,3158,1649472,289382,1078270,1355,692,33594,125469,1331,604,255788,952801,24,88,103592,2749954,4857,13537,362294,576,0,87,1,2,601,1
Alistipes_onderdonkii_55464,700117938,ERR912161,3444,1661220,291174,1086094,1467,789,43132,159889,1428,692,248042,926205,39,97,101016,2672973,4626,17167,461699,801,0,95,2,0,692,0
Alistipes_onderdonkii_55464,700117938,SRR413610,4253,1645563,288934,1076067,1813,900,52132,194908,1777,797,236802,881159,36,103,95586,2543712,4179,21080,562768,876,0,103,0,1,795,1
Alistipes_onderdonkii_55464,700119562,ERR912048,3472,1749199,309265,1145075,1541,788,38505,143572,1507,683,270760,1001503,34,105,106704,2892789,5016,15416,414709,591,0,104,1,2,679,2
Alistipes_onderdonkii_55464,700119562,ERR912143,3084,1746258,308810,1143034,1295,749,33837,126970,1266,665,274973,1016064,29,84,108279,2934798,5115,13712,366703,495,0,83,1,3,662,0
Alistipes_onderdonkii_55464,700119562,ERR912153,3784,1741355,307929,1139855,1648,836,44914,168006,1608,702,263015,971849,40,134,103521,2807085,4941,18207,485139,672,0,133,1,2,699,1
Alistipes_onderdonkii_55464,700119739,700120753,3141,1743667,308332,1141443,1247,804,30420,112163,1212,700,277912,1029280,35,104,109825,2972963,5052,11938,324047,504,0,103,1,1,699,0
Alistipes_onderdonkii_55464,700119739,700163772,3946,1688049,297337,1104249,1684,843,41966,155097,1651,719,255371,949152,33,124,102299,2740396,4761,16580,447955,756,2,122,0,1,718,0
Alistipes_onderdonkii_55464,700119739,700164735,2528,1748375,309001,1144481,1042,595,27955,103585,1002,495,281046,1040896,40,100,110985,3006666,5037,11128,299123,504,0,100,0,1,493,1
Alistipes_onderdonkii_55464,700119739,700171115,3939,1731163,305772,1133095,1614,943,43853,162640,1579,833,261919,970455,35,110,103663,2802911,4791,17369,469792,759,1,108,1,4,829,0
Alistipes_onderdonkii_55464,700119739,ERR911956,2501,1750181,309540,1145676,1026,572,26927,98056,1010,498,282613,1047620,16,74,111983,3025693,5184,10251,283467,450,0,74,0,1,496,1
Alistipes_onderdonkii_55464,700119739,ERR911988,2510,1742152,308146,1140377,1022,611,27853,103130,1001,502,280293,1037247,21,109,110824,2995799,5118,10824,298125,441,0,109,0,0,502,0
Alistipes_onderdonkii_55464,700119739,ERR911992,2304,1750455,309543,1145805,916,525,24216,89617,894,435,285327,1056188,22,90,112604,3050746,5214,9661,258797,393,0,89,1,0,433,2
Alistipes_onderdonkii_55464,700119739,ERR912036,4078,1747664,309077,1144004,1718,935,39967,146982,1684,818,269110,997022,34,117,106614,2879466,4986,15467,424855,624,1,115,1,0,818,0
Alistipes_onderdonkii_55464,700119739,ERR912037,2365,1752838,309928,1147380,931,544,27565,101454,900,438,282363,1045926,31,106,111717,3020877,5184,10763,293161,438,0,106,0,0,437,1
Alistipes_onderdonkii_55464,700119739,ERR912076,1324,1755064,310292,1148926,507,333,14225,52917,488,280,296067,1096009,19,53,116960,3165679,5388,5647,152864,240,0,53,0,1,279,0
Alistipes_onderdonkii_55464,700119739,ERR912078,4109,1747706,308968,1144035,1698,1006,42270,154902,1670,908,266698,989133,28,98,105777,2856765,4857,16359,447591,756,0,98,0,2,905,1
Alistipes_onderdonkii_55464,700119739,ERR912126,1927,1728967,305677,1131522,784,459,19715,72892,762,399,285962,1058630,22,60,113013,3057702,5175,7855,210437,384,1,59,0,0,398,1
Alistipes_onderdonkii_55464,700119739,ERR912128,4661,1737042,307147,1136827,1982,1112,54520,200357,1963,997,252627,936470,19,115,100375,2704328,4707,21156,579060,855,0,114,1,2,993,2
Alistipes_onderdonkii_55464,700119739,mickey4-11-0-0_,2548,1733750,306001,1134922,1059,612,33368,122400,1017,527,272633,1012522,42,85,108316,2924339,4911,13019,353566,615,1,84,0,0,527,0
Alistipes_onderdonkii_55464,700119739,pluto3-11-7-0_,2583,1725409,304709,1129571,1049,585,33198,123704,1026,490,271511,1005867,23,95,107257,2905469,4875,13375,357158,579,1,94,0,0,490,0
Alistipes_onderdonkii_55464,700120753,700164735,3563,1744305,308214,1141863,1473,873,35335,131266,1420,762,272879,1010597,53,111,107818,2919107,4866,14037,379116,645,0,111,0,2,758,2
Alistipes_onderdonkii_55464,700120753,700171115,2349,1728586,305253,1131436,952,534,27381,102420,914,439,277872,1029016,38,95,109648,2972324,5076,11182,295619,459,1,94,0,2,437,0
Alistipes_onderdonkii_55464,700120753,ERR911956,3557,1744675,308489,1142085,1482,848,36167,131755,1447,767,272322,1010330,35,81,108102,2917881,5007,13772,380926,567,0,81,0,2,763,2
Alistipes_onderdonkii_55464,700120753,ERR911972,5008,1737224,306919,1137220,2104,1205,53896,199808,2072,1088,253023,937412,32,117,99936,2707779,4521,21530,576892,1002,0,117,0,4,1084,0
Alistipes_onderdonkii_55464,700120753,ERR911988,3458,1736217,306980,1136536,1430,834,33704,125559,1372,717,273276,1010977,58,117,107999,2919988,4944,13257,362838,582,0,117,0,1,715,1
Alistipes_onderdonkii_55464,700120753,ERR911992,3362,1744889,308468,1142194,1361,838,33663,123623,1322,722,274805,1018571,39,116,108830,2941858,5025,13068,357270,531,0,115,1,1,718,3
Alistipes_onderdonkii_55464,700120753,ERR912033,3633,1741026,307773,1139720,1507,877,43215,160148,1466,753,264558,979572,41,124,104822,2829079,4815,16855,462860,729,0,124,0,0,753,0
Alistipes_onderdonkii_55464,700120753,ERR912036,2467,1743247,308186,1141106,1062,544,24989,92713,1029,446,283197,1048393,33,98,111919,3028010,5250,9898,267896,345,1,97,0,1,445,0
Alistipes_onderdonkii_55464,700120753,ERR912037,3561,1746613,308770,1143307,1452,868,37532,137632,1401,751,271238,1005675,51,117,107511,2904546,4968,14546,397759,591,0,117,0,1,748,2
Alistipes_onderdonkii_55464,700120753,ERR912061,3890,1739050,307378,1138334,1640,899,42693,158889,1600,777,264685,979445,40,122,104635,2828915,4785,16852,459071,744,1,121,0,0,776,1
Alistipes_onderdonkii_55464,700120753,ERR912076,2484,1748225,308990,1144429,1007,621,24453,90767,972,548,284537,1053662,35,73,112455,3043344,5187,9699,262212,390,0,73,0,2,545,1
Alistipes_onderdonkii_55464,700120753,ERR912078,2548,1743786,308200,1141468,1052,622,24443,89898,1013,525,283757,1051570,39,97,112285,3037265,5160,9611,259687,396,0,96,1,3,521,1
Alistipes_onderdonkii_55464,700120753,ERR912126,2979,1723201,304580,1127792,1244,722,28317,105181,1205,641,276263,1022611,39,81,109112,2953723,4998,11351,303694,498,1,80,0,1,638,2
Alistipes_onderdonkii_55464,700120753,ERR912128,3254,1734276,306550,1135056,1383,770,35543,131151,1352,644,271007,1003905,31,126,107278,2899442,4995,14046,378888,519,0,124,2,1,643,0
Alistipes_onderdonkii_55464,700120753,ERR912159,3777,1728435,305229,1131310,1611,813,38549,143621,1567,680,266680,987689,44,133,105452,2852704,4911,15524,414700,639,0,132,1,0,680,0
Alistipes_onderdonkii_55464,700120753,ERR912188,3927,1749381,309185,1145259,1663,866,37280,139656,1633,766,271905,1005603,30,100,107005,2904833,4971,15254,403117,597,1,99,0,1,764,1
Alistipes_onderdonkii_55464,700120753,mickey4-11-0-0_,3624,1727830,304918,1131007,1525,861,38147,140017,1479,762,266771,990990,46,99,106063,2862107,4800,14871,404538,642,1,98,0,1,760,1
Alistipes_onderdonkii_55464,700120753,pluto3-11-7-0_,3526,1721121,303886,1126709,1423,819,38845,144147,1383,711,265041,982562,40,108,104670,2838249,4767,15669,416136,636,0,108,0,2,708,1
Alistipes_onderdonkii_55464,700161742,700172221,1286,1706197,300248,1115666,544,293,13654,51651,525,241,286594,1064015,19,52,115182,3071499,5364,5404,149330,219,1,51,0,0,241,0
Alistipes_onderdonkii_55464,700161742,700172813,1559,1709554,301348,1118250,652,337,19347,72829,643,282,282001,1045421,9,55,112496,3018553,5214,7823,210328,336,1,54,0,0,282,0
Alistipes_onderdonkii_55464,700161742,SRR2822459,3578,1706813,300780,1116458,1559,772,39849,147455,1526,631,260931,969003,33,141,104407,2797877,4725,15751,425858,756,2,139,0,0,630,1
Alistipes_onderdonkii_55464,700163772,ERR911956,4353,1691916,298020,1106746,1888,904,46410,170166,1848,803,251610,936580,40,101,101184,2703843,4713,17983,491705,810,2,99,0,2,800,1
Alistipes_onderdonkii_55464,700163772,ERR912076,3399,1696531,298679,1109816,1485,709,35011,129887,1451,606,263668,979929,34,103,105699,2829135,4953,13833,375252,576,2,101,0,2,604,0
Alistipes_onderdonkii_55464,700163772,ERR912126,3651,1673235,294636,1094364,1618,761,43070,159602,1585,674,251566,934762,33,87,100837,2698757,4692,17074,460976,756,2,85,0,2,671,1
Alistipes_onderdonkii_55464,700164735,ERR911956,3160,1754155,309971,1148304,1331,712,34376,126182,1294,622,275595,1022122,37,90,109247,2952073,5046,13298,364699,549,0,90,0,2,618,2
Alistipes_onderdonkii_55464,700164735,ERR911988,2992,1745962,308498,1142886,1277,718,33714,124913,1220,588,274784,1017973,57,130,108881,2940067,4971,13080,361098,561,0,130,0,1,586,1
Alistipes_onderdonkii_55464,700164735,ERR911992,2847,1754310,309950,1148376,1176,671,32049,118297,1134,564,277901,1030079,42,107,109940,2975242,5055,12638,341722,531,0,106,1,1,560,3
Alistipes_onderdonkii_55464,700164735,ERR912037,3209,1756668,310352,1149931,1331,740,38078,140762,1283,626,272274,1009169,48,114,107816,2914774,4917,14968,406652,666,0,114,0,1,623,2
Alistipes_onderdonkii_55464,700164735,ERR912076,1974,1758561,310607,1151234,834,470,21775,81505,795,394,288832,1069729,39,76,114094,3089873,5220,8788,235364,363,0,76,0,2,391,1
Alistipes_onderdonkii_55464,700164735,ERR912126,2454,1734756,306438,1135372,1052,544,26938,100041,1010,463,279500,1035331,42,81,110485,2990462,5046,10785,288834,504,1,80,0,1,460,2
Alistipes_onderdonkii_55464,700164735,mickey4-11-0-0_,3130,1738632,306647,1138114,1328,714,38339,141958,1269,605,268308,996156,59,109,106482,2877222,4764,15178,409976,720,1,108,0,1,603,1
Alistipes_onderdonkii_55464,700164735,pluto3-11-7-0_,3237,1729979,305330,1132534,1331,726,37913,142208,1280,601,267417,990326,51,125,105451,2860760,4767,15517,410447,660,0,125,0,2,598,1
Alistipes_onderdonkii_55464,700165148,ERR912153,3472,1650342,288874,1079340,1476,773,40097,151193,1432,666,248777,928147,44,107,100911,2678706,4824,16408,436550,621,0,107,0,3,661,2
Alistipes_onderdonkii_55464,700165224,ERR912138,1691,1867350,330296,1222337,753,384,36973,135690,719,297,293323,1086647,34,87,116202,3137574,6165,14150,392161,759,1,86,0,0,297,0
Alistipes_onderdonkii_55464,700171115,ERR911956,4569,1735153,306477,1135648,1896,1011,51838,190840,1853,916,254639,944808,43,95,101041,2728652,4731,20286,551379,855,1,94,0,5,909,2
Alistipes_onderdonkii_55464,700171115,ERR911988,4247,1727214,305014,1130490,1792,948,46278,171968,1739,814,258736,958522,53,134,102562,2768273,4731,18213,496908,783,2,132,0,2,811,1
Alistipes_onderdonkii_55464,700171115,ERR912036,3479,1735147,306399,1135640,1499,735,40756,151449,1458,624,265643,984191,41,111,105169,2842499,4905,16176,437484,687,3,108,0,2,622,0
Alistipes_onderdonkii_55464,700171115,ERR912076,3373,1740399,307209,1139204,1386,783,39270,145996,1350,696,267939,993208,36,87,106102,2868596,4926,15644,421684,660,1,86,0,4,691,1
Alistipes_onderdonkii_55464,700171115,ERR912078,3345,1736487,306522,1136585,1430,766,39617,146552,1388,673,266905,990033,42,93,105871,2859338,4890,15673,423290,693,2,90,1,4,668,1
Alistipes_onderdonkii_55464,700171115,ERR912126,3811,1726941,304835,1130226,1608,868,41254,153738,1564,771,263581,976488,44,97,104287,2820380,4797,16601,443887,726,3,94,0,3,766,2
Alistipes_onderdonkii_55464,700171115,ERR912188,4661,1741329,307393,1139842,2013,981,50150,187400,1985,863,257243,952442,28,118,101497,2751080,4749,20289,541086,825,3,115,0,2,860,1
Alistipes_onderdonkii_55464,700172221,700172813,1468,1723792,303896,1127874,578,389,17620,65951,567,309,286276,1061923,11,80,114162,3066294,5313,6947,190630,276,0,80,0,0,309,0
Alistipes_onderdonkii_55464,700172221,SRR2822459,3457,1722262,303511,1126879,1490,786,41876,154486,1458,647,261635,972393,32,139,104730,2807619,4830,16292,446449,717,1,138,0,0,645,2
Alistipes_onderdonkii_55464,ERR911956,ERR911988,2951,1754744,310319,1148639,1266,667,32458,118864,1232,560,277861,1029775,34,107,110271,2973909,5145,12256,343865,471,0,107,0,0,559,1
Alistipes_onderdonkii_55464,ERR911956,ERR911992,2793,1765469,312176,1155667,1147,642,32578,118217,1121,570,279598,1037450,26,72,111010,2996099,5241,12293,341902,456,0,71,1,1,566,3
Alistipes_onderdonkii_55464,ERR911956,ERR912036,4639,1760302,311262,1152309,1992,1013,49720,181925,1969,928,261542,970384,23,85,103986,2802237,4929,19012,526043,720,1,84,0,1,925,2
Alistipes_onderdonkii_55464,ERR911956,ERR912037,3055,1765865,312177,1155982,1255,724,35223,128519,1219,634,276954,1027463,36,90,109956,2967303,5130,13440,371574,543,0,90,0,1,631,2
Alistipes_onderdonkii_55464,ERR911956,ERR912076,1877,1767815,312559,1157260,779,439,20766,75356,763,402,291793,1081904,16,37,115689,3124605,5418,7803,217974,291,0,37,0,2,399,1
Alistipes_onderdonkii_55464,ERR911956,ERR912078,4666,1759781,311093,1151991,1952,1083,45892,167656,1928,1001,265201,984335,24,82,105305,2842783,4917,17686,484538,744,0,82,0,1,998,2
Alistipes_onderdonkii_55464,ERR911956,ERR912126,2355,1742667,308092,1140534,1008,526,26039,94912,995,487,282053,1045622,13,39,111877,3019775,5214,9905,274390,441,1,38,0,1,486,0
Alistipes_onderdonkii_55464,ERR911956,mickey4-11-0-0_,3193,1742701,307576,1140785,1364,703,39351,142145,1329,630,268225,998640,35,73,107149,2883845,4926,14807,410974,654,1,72,0,0,629,1
Alistipes_onderdonkii_55464,ERR911956,pluto3-11-7-0_,3028,1734961,306372,1135815,1242,657,35105,129821,1214,565,271267,1005994,28,92,107557,2905454,4971,13769,375145,549,0,92,0,1,563,1
Alistipes_onderdonkii_55464,ERR911963,ERR912089,4972,1752058,309742,1146887,2108,1139,54061,202178,2091,1052,255681,944709,17,87,101090,2728183,4854,21365,584320,849,0,87,0,1,1051,0
Alistipes_onderdonkii_55464,ERR911963,ERR912153,3667,1751561,309664,1146538,1585,793,46245,173525,1551,702,263419,973013,34,91,103849,2810195,4995,18686,501226,663,0,91,0,1,700,1
Alistipes_onderdonkii_55464,ERR911968,ERR912092,2754,1872846,331485,1225984,1144,660,38492,143847,1107,553,292993,1082137,37,107,115153,3125036,6222,15520,415268,753,1,105,1,2,549,2
Alistipes_onderdonkii_55464,ERR911971,ERR911985,3386,1760841,311266,1152827,1401,840,36481,133265,1376,754,274785,1019562,25,86,109147,2944508,5031,13841,385327,627,2,83,1,1,751,2
Alistipes_onderdonkii_55464,ERR911971,ERR912007,4021,1752222,309698,1147033,1732,915,47639,179680,1712,803,262059,967353,20,112,102807,2794353,4899,19620,518673,747,0,111,1,2,801,0
Alistipes_onderdonkii_55464,ERR911971,ERR912041,4311,1756448,310499,1149825,1799,1014,45888,170067,1767,906,264611,979758,32,108,104599,2829788,4887,18145,491336,720,1,106,1,2,902,2
Alistipes_onderdonkii_55464,ERR911985,ERR912041,3560,1761970,311529,1153454,1519,827,39913,146066,1492,718,271616,1007388,27,109,107833,2909336,4995,15316,422237,645,3,106,0,1,717,0
Alistipes_onderdonkii_55464,ERR911988,ERR911992,2790,1754982,310269,1148795,1158,678,32574,120249,1130,568,277695,1028546,28,110,109973,2970523,5142,12590,347674,483,0,110,0,0,565,3
Alistipes_onderdonkii_55464,ERR911988,ERR912036,4420,1751171,309648,1146317,1896,961,47002,174755,1863,841,262646,971562,33,120,103747,2806040,4899,18554,505024,687,1,119,0,0,840,1
Alistipes_onderdonkii_55464,ERR911988,ERR912037,3094,1760462,311234,1152431,1299,730,37716,139557,1257,616,273518,1012874,42,114,108325,2925329,4968,14665,403388,618,0,114,0,0,615,1
Alistipes_onderdonkii_55464,ERR911988,ERR912076,1747,1761657,311354,1153301,733,418,19931,74863,704,332,291423,1078438,29,86,115294,3114686,5334,7744,216560,285,0,86,0,1,331,0
Alistipes_onderdonkii_55464,ERR911988,ERR912078,4400,1754326,310072,1148443,1863,1011,47279,173933,1819,900,262793,974510,44,111,104404,2814374,4752,18177,502800,822,1,110,0,0,899,1
Alistipes_onderdonkii_55464,ERR911988,ERR912126,2258,1737227,307075,1137018,975,546,25158,93579,942,465,281917,1043439,33,81,111529,3013622,5166,9858,270465,414,1,80,0,0,464,1
Alistipes_onderdonkii_55464,ERR911988,mickey4-11-0-0_,3193,1734635,306135,1135497,1367,754,42914,157878,1305,647,263221,977619,62,107,104839,2823245,4773,16556,456373,705,1,106,0,0,647,0
Alistipes_onderdonkii_55464,ERR911988,pluto3-11-7-0_,3085,1727006,304967,1130596,1290,693,39383,146940,1254,579,265584,983656,36,114,105081,2841051,4836,15662,424558,600,0,114,0,1,578,0
Alistipes_onderdonkii_55464,ERR911992,ERR912036,4389,1761218,311385,1152837,1850,991,45129,165371,1812,871,266256,987466,38,120,105646,2851757,4995,17413,478046,654,1,118,1,0,868,3
Alistipes_onderdonkii_55464,ERR911992,ERR912037,2725,1765842,312131,1155909,1103,626,32779,120795,1064,523,279352,1035114,39,103,110500,2989667,5175,12906,348987,492,0,102,1,0,522,1
Alistipes_onderdonkii_55464,ERR911992,ERR912076,1656,1767502,312426,1156967,651,397,17584,64617,635,338,294842,1092350,16,59,116636,3154966,5448,6824,186781,246,1,57,1,0,336,2
Alistipes_onderdonkii_55464,ERR911992,ERR912078,4502,1759921,311085,1152019,1866,1070,47102,172110,1832,960,263983,979909,34,110,104870,2829991,4866,18121,497426,783,0,109,1,2,955,3
Alistipes_onderdonkii_55464,ERR911992,ERR912126,2267,1743667,308161,1141162,935,536,25045,92092,908,462,283116,1049070,27,74,112009,3029966,5235,9859,266006,411,1,72,1,0,459,3
Alistipes_onderdonkii_55464,ERR911992,mickey4-11-0-0_,3026,1742914,307542,1140898,1264,702,40262,148435,1223,605,267280,992463,41,97,106129,2866361,4899,15865,428756,684,1,95,1,0,604,1
Alistipes_onderdonkii_55464,ERR911992,pluto3-11-7-0_,2973,1735132,306349,1135875,1209,653,35600,131962,1180,555,270749,1003913,29,98,107128,2899667,4944,14224,381107,555,0,97,1,1,553,1
Alistipes_onderdonkii_55464,ERR912036,ERR912037,4551,1762193,311539,1153530,1931,1020,49466,182832,1893,900,262073,970698,38,120,103761,2803446,4887,19418,528331,747,1,119,0,0,898,2
Alistipes_onderdonkii_55464,ERR912036,ERR912076,3578,1764083,311828,1154781,1525,788,36927,136428,1498,698,274901,1018353,27,90,108846,2941050,5163,14415,394353,516,1,89,0,1,696,1
Alistipes_onderdonkii_55464,ERR912036,ERR912078,3555,1759449,310961,1151770,1519,804,34791,127464,1485,682,276170,1024306,34,122,109512,2958321,5085,13500,368319,573,1,120,1,2,679,1
Alistipes_onderdonkii_55464,ERR912036,ERR912126,3914,1738256,307232,1137632,1696,842,40679,150672,1657,741,266553,986960,39,101,105402,2850516,4962,16095,435294,627,2,99,0,0,739,2
Alistipes_onderdonkii_55464,ERR912036,ERR912128,4179,1748786,309116,1144566,1817,939,47975,177252,1786,811,261141,967314,31,128,103514,2793547,4881,18891,512154,711,1,125,2,2,809,0
Alistipes_onderdonkii_55464,ERR912036,ERR912159,4755,1746365,308388,1143079,2063,1016,54173,200126,2035,881,254215,942953,28,135,100903,2723246,4710,21322,578138,918,1,133,1,2,879,0
Alistipes_onderdonkii_55464,ERR912036,ERR912188,4704,1765949,312144,1156115,2052,1027,49671,184547,2028,931,262473,971568,24,96,103595,2806261,4848,19794,533046,801,2,94,0,3,927,1
Alistipes_onderdonkii_55464,ERR912037,ERR912076,1925,1772834,313252,1160629,764,481,23835,88284,737,393,289417,1072345,27,88,114584,3097165,5286,9320,255148,384,0,88,0,1,391,1
Alistipes_onderdonkii_55464,ERR912037,ERR912126,2480,1748099,308887,1144166,1033,590,28772,105867,994,501,280115,1038299,39,89,110960,2998840,5097,11278,305813,510,1,88,0,0,499,2
Alistipes_onderdonkii_55464,ERR912037,mickey4-11-0-0_,3164,1746741,308174,1143462,1320,726,40217,148167,1265,607,267957,995295,55,119,106489,2874530,4866,15836,427981,684,1,118,0,0,606,1
Alistipes_onderdonkii_55464,ERR912037,pluto3-11-7-0_,3063,1739392,307049,1138737,1272,673,41612,153693,1226,563,265437,985044,46,110,105291,2845074,4767,16388,443977,714,0,110,0,1,561,1
Alistipes_onderdonkii_55464,ERR912048,ERR912143,2441,1766256,312285,1156055,1035,596,25618,94414,1005,505,286667,1061641,30,91,113428,3066170,5325,10084,272771,387,1,90,0,4,497,4
Alistipes_onderdonkii_55464,ERR912048,ERR912153,3879,1763109,311648,1154197,1714,855,44354,165032,1673,710,267294,989165,41,145,105492,2857059,4944,17864,476482,750,0,145,0,4,701,5
Alistipes_onderdonkii_55464,ERR912070,ERR912085,2555,1751089,309533,1146200,1100,544,32559,120795,1085,477,276974,1025405,15,67,109471,2961560,5184,12835,349034,516,1,66,0,2,474,1
Alistipes_onderdonkii_55464,ERR912076,ERR912078,3556,1767429,312229,1157095,1491,843,35566,130705,1461,767,276663,1026390,30,76,109720,2964392,5058,13827,377676,612,0,76,0,3,763,1
Alistipes_onderdonkii_55464,ERR912076,ERR912126,1169,1749381,309125,1145009,490,284,14049,52688,474,254,295076,1092321,16,30,116544,3155025,5394,5736,152079,249,1,29,0,0,253,1
Alistipes_onderdonkii_55464,ERR912076,ERR912128,4226,1752045,309632,1146766,1812,993,47304,174352,1783,890,262328,972414,29,103,104122,2808263,4857,18496,503828,732,0,102,1,3,886,1
Alistipes_onderdonkii_55464,ERR912076,ERR912188,4950,1773745,313360,1161322,2123,1090,53872,199694,2108,1000,259488,961628,15,90,102692,2777425,4767,21242,576955,885,1,89,0,3,995,2
Alistipes_onderdonkii_55464,ERR912076,mickey4-11-0-0_,2088,1747535,308264,1144022,877,488,25956,95633,830,402,282308,1048389,47,86,112187,3027802,5178,10157,276322,420,1,85,0,1,401,0
Alistipes_onderdonkii_55464,ERR912076,pluto3-11-7-0_,2019,1739332,307006,1138716,812,446,24923,93619,783,366,282083,1045097,29,80,111462,3018711,5118,10180,270281,396,0,80,0,2,364,0
Alistipes_onderdonkii_55464,ERR912078,ERR912126,4020,1741774,307760,1139993,1688,951,40360,148522,1655,865,267400,991471,33,86,106001,2863558,4854,15800,429028,738,0,86,0,3,860,2
Alistipes_onderdonkii_55464,ERR912078,ERR912128,4258,1748402,308960,1144321,1843,1002,48795,179678,1809,875,260165,964643,34,127,103401,2785755,4773,19045,519176,813,0,125,2,4,869,2
Alistipes_onderdonkii_55464,ERR912078,ERR912188,4245,1769333,312587,1158416,1792,984,46439,172149,1766,885,266148,986267,26,99,105286,2848661,4854,18411,497247,789,1,98,0,5,879,1
Alistipes_onderdonkii_55464,ERR912078,pluto3-11-7-0_,4478,1732784,305840,1134397,1844,1004,49628,183380,1813,888,256212,951017,31,116,101455,2747024,4572,19763,529468,909,0,116,0,0,888,0
Alistipes_onderdonkii_55464,ERR912089,ERR912153,3734,1754366,310198,1148355,1591,850,40943,151469,1551,738,269255,996886,40,112,106702,2878961,4995,16038,437643,726,0,112,0,0,737,1
Alistipes_onderdonkii_55464,ERR912126,ERR912188,5208,1749382,309101,1145059,2242,1148,56952,212132,2226,1069,252149,932927,16,79,99446,2694757,4578,22845,612519,1032,2,77,0,2,1064,3
Alistipes_onderdonkii_55464,ERR912126,mickey4-11-0-0_,2512,1723685,304105,1128096,1052,577,30646,112812,1014,496,273459,1015284,38,81,108592,2932301,4959,12076,325796,564,2,79,0,0,495,1
Alistipes_onderdonkii_55464,ERR912126,pluto3-11-7-0_,2363,1715440,302844,1122793,978,521,30537,114084,950,446,272307,1008709,28,75,107546,2913685,4896,12448,329231,573,1,74,0,1,444,1
Alistipes_onderdonkii_55464,ERR912143,ERR912153,3374,1757716,310787,1150421,1443,801,39565,147236,1393,690,271222,1003185,50,111,107139,2897436,4980,15940,425072,696,2,109,0,4,685,1
Alistipes_onderdonkii_55464,SRR413610,ERR912076,4984,1738968,307353,1138675,2141,1054,56003,209377,2108,951,251350,929298,33,103,98934,2684727,4233,22387,604841,903,0,103,0,3,947,1
Alistipes_onderdonkii_55464,mickey4-11-0-0_,pluto3-11-7-0_,3153,1728464,304706,1131516,1323,678,47626,177309,1291,575,257080,954207,32,103,101885,2756074,4662,19182,511926,819,1,102,0,1,574,0
