species_name,sample 1,sample 2,core_diff,core_len,core_len_4D,core_len_1D,core_diff_4D,core_diff_1D,recomb_len_4D,recomb_len_1D,recomb_diff_4D,recomb_diff_1D,clonal_len_4D,clonal_len_1D,clonal_diff_4D,clonal_diff_1D,clonal_n,clonal_m,clonal_nn,recomb_n,recomb_m,recomb_nn,clonal_mut_n,clonal_mut_m,clonal_mut_nn,recomb_mut_n,recomb_mut_m,recomb_mut_nn
Bacteroides_vulgatus_57955,700013715,700037042,1304,1459411,202782,948351,469,351,61775,288448,458,282,141007,659903,11,69,102589,1873790,3330,44631,819453,1260,2,67,0,2,280,0
Bacteroides_vulgatus_57955,700013715,ERR911986,1284,1410926,196014,916729,461,351,54485,253345,434,257,141529,663384,27,94,103463,1883380,3309,39009,719892,1134,1,93,0,1,256,0
Bacteroides_vulgatus_57955,700013715,ERR912181,1435,1491050,207315,968955,514,375,67450,313894,498,296,139865,655061,16,79,101877,1860111,3195,48543,891807,1332,0,79,0,1,295,0
Bacteroides_vulgatus_57955,700014486,700161429,1606,1991038,277876,1294001,594,399,65040,302783,585,368,212836,991218,9,31,152636,2815972,5046,46489,860345,1515,2,29,0,0,368,0
Bacteroides_vulgatus_57955,700014486,ERR912153,1147,1994059,278301,1295917,395,298,41418,191383,358,220,236883,1104534,37,78,170587,3137378,5637,28855,544355,939,3,75,0,0,219,1
Bacteroides_vulgatus_57955,700014562,700024711,1891,1974246,275513,1283008,698,428,87478,405431,677,363,188035,877577,21,65,135573,2492667,4491,62155,1152128,2010,1,64,0,2,361,0
Bacteroides_vulgatus_57955,700015415,700111296,403,1911911,266274,1242169,166,97,11721,53429,154,63,254553,1188740,12,34,183957,3376152,6111,8100,151941,246,1,33,0,0,63,0
Bacteroides_vulgatus_57955,700015415,SRR341723,495,1909297,265773,1240465,202,122,15880,73069,186,84,249893,1167396,16,38,180734,3315469,5985,11139,207729,339,1,37,0,0,84,0
Bacteroides_vulgatus_57955,700016142,ERR912152,1409,1501113,209041,975810,541,332,13633,61978,489,264,195408,913832,52,68,141200,2596120,4176,9404,176275,255,0,68,0,0,264,0
Bacteroides_vulgatus_57955,700016765,700021902,764,1916320,267184,1245305,257,194,29519,137922,250,157,237665,1107383,7,37,171196,3145409,5544,20929,392141,696,0,37,0,0,157,0
Bacteroides_vulgatus_57955,700016765,700023390,303,1921090,267930,1248388,97,92,12071,56294,90,77,255859,1192094,7,15,183950,3386344,5988,8566,160067,249,0,15,0,1,75,1
Bacteroides_vulgatus_57955,700016765,700033922,631,1920228,267649,1247847,234,149,34747,163013,230,125,232902,1084834,4,24,167558,3081457,5487,24993,463281,765,0,24,0,0,124,1
Bacteroides_vulgatus_57955,700016765,700161743,1824,1913772,266664,1243675,637,455,91708,427681,624,396,174956,815994,13,59,126544,2317457,3981,65392,1215434,2217,1,58,0,0,396,0
Bacteroides_vulgatus_57955,700021361,700034794,1772,1908313,265798,1240029,666,429,66448,308351,636,346,199350,931678,30,83,143995,2646302,4737,47272,876110,1671,2,81,0,1,345,0
Bacteroides_vulgatus_57955,700021361,700111745,1854,1919665,267624,1247453,681,468,81404,379772,666,382,186220,867681,15,86,134069,2464534,4440,58209,1079133,1974,1,85,0,2,380,0
Bacteroides_vulgatus_57955,700021361,700161872,1772,1937038,270194,1258781,646,444,73343,340814,631,370,196851,917967,15,74,141761,2607505,4635,52184,968404,1854,1,73,0,2,368,0
Bacteroides_vulgatus_57955,700021361,700163811,1778,1928278,269029,1253054,644,448,67589,314149,624,370,201440,938905,20,78,144865,2667107,4743,48085,892640,1722,0,78,0,3,367,0
Bacteroides_vulgatus_57955,700021361,700172498,660,1933568,269570,1256514,236,176,19412,90384,225,110,250158,1166130,11,66,179621,3312727,6042,13983,256719,450,0,66,0,0,110,0
Bacteroides_vulgatus_57955,700021361,ERR912110,2111,1952245,272282,1268721,788,507,80399,372863,762,426,191883,895858,26,81,138867,2544084,4623,56632,1060055,1902,0,81,0,1,425,0
Bacteroides_vulgatus_57955,700021902,700023390,1019,1922980,268110,1249558,339,267,38481,179871,329,222,229629,1069687,10,45,165301,3038255,5505,27370,511346,897,0,45,0,1,220,1
Bacteroides_vulgatus_57955,700021902,700033922,1279,1924428,268204,1250508,447,320,57647,269979,433,266,210557,980529,14,54,151627,2784893,5067,41263,767324,1350,0,54,0,0,265,1
Bacteroides_vulgatus_57955,700021902,700113705,755,1930659,269168,1254616,254,198,25226,118114,239,151,243942,1136502,15,47,175458,3228234,5814,17996,335728,618,0,47,0,0,151,0
Bacteroides_vulgatus_57955,700021902,SRR341721,844,1927369,268466,1252433,290,210,29986,140168,281,173,238480,1112265,9,37,171976,3159098,5721,21364,398405,735,0,37,0,0,173,0
Bacteroides_vulgatus_57955,700021902,SRR413643,847,1935222,269801,1257582,289,215,30840,143812,280,176,238961,1113770,9,39,172125,3163476,5709,21864,408822,750,0,39,0,1,175,0
Bacteroides_vulgatus_57955,700023188,700033989,910,1899181,264717,1234135,330,259,43920,201370,317,199,220797,1032765,13,60,159764,2933443,5088,30522,572556,1032,3,57,0,2,197,0
Bacteroides_vulgatus_57955,700023188,700111439,1773,1909785,266037,1241030,662,464,90416,417409,640,388,175621,823621,22,76,127806,2338779,4278,63530,1186561,2136,0,75,1,5,383,0
Bacteroides_vulgatus_57955,700023188,700164354,1485,1910286,266255,1241338,537,407,78207,359798,509,338,188048,881540,28,69,136731,2503323,4566,54552,1023051,1791,6,63,0,2,336,0
Bacteroides_vulgatus_57955,700023267,700161219,1186,1433903,199110,931868,385,370,33941,156789,351,292,165169,775079,34,78,120416,2201257,3564,23832,445710,825,1,77,0,1,291,0
Bacteroides_vulgatus_57955,700023267,ERR912035,293,1468298,203622,954223,104,85,1235,5888,101,67,202387,948335,3,18,147159,2693334,4512,961,16679,24,1,17,0,0,67,0
Bacteroides_vulgatus_57955,700023267,ERR912100,1170,1473953,204344,957895,387,341,62334,290248,365,268,142010,667647,22,73,104191,1895540,3210,44539,824789,1416,1,72,0,0,268,0
Bacteroides_vulgatus_57955,700023267,ERR912201,290,1419907,196759,922672,106,83,1235,5895,101,67,195524,916777,5,16,142432,2603405,4494,961,16700,24,1,15,0,0,67,0
Bacteroides_vulgatus_57955,700023267,SRR341638,1050,1424117,196778,925648,356,293,53320,249508,342,226,143458,676140,14,67,105593,1919674,3153,38343,708984,1197,1,66,0,0,226,0
Bacteroides_vulgatus_57955,700023267,SRR341714,66,1458123,201795,947574,17,22,430,1946,13,4,201365,945628,4,18,147049,2685329,4506,276,5559,3,1,16,1,0,4,0
Bacteroides_vulgatus_57955,700023267,SRR413585,177,1456382,201746,946525,50,59,1161,5006,50,43,200585,941519,0,16,146282,2673910,4365,694,14276,48,1,14,1,0,43,0
Bacteroides_vulgatus_57955,700023267,SRR413603,1120,1457317,202043,947165,371,326,54183,252697,353,250,147860,694468,18,76,108337,1971902,3165,38746,718154,1191,1,74,1,0,250,0
Bacteroides_vulgatus_57955,700023267,SRR413610,1118,1441147,200052,936736,373,310,53802,250622,357,246,146250,686114,16,64,106844,1948408,3090,38348,712357,1161,1,62,1,0,246,0
Bacteroides_vulgatus_57955,700023390,700033922,769,1930759,269122,1254625,276,201,41826,196067,273,182,227296,1058558,3,19,163521,3006696,5457,29964,557277,960,0,19,0,1,181,0
Bacteroides_vulgatus_57955,700023390,700113705,298,1936871,270162,1258609,97,90,12509,58444,89,75,257653,1200165,8,15,185044,3409286,6165,8881,166181,270,0,15,0,1,73,1
Bacteroides_vulgatus_57955,700023390,700161743,2004,1921081,267680,1248298,691,508,94949,443527,672,437,172731,804771,19,71,124315,2285915,4083,68187,1260135,2259,1,70,0,1,435,1
Bacteroides_vulgatus_57955,700023390,SRR341721,392,1938521,270160,1259702,134,102,12897,60167,127,89,257263,1199535,7,13,185107,3407336,6162,9162,171069,270,0,13,0,1,87,1
Bacteroides_vulgatus_57955,700023390,SRR413643,394,1946393,271524,1264845,138,107,12928,60279,129,91,258596,1204566,9,16,185747,3421786,6165,9166,171401,270,1,15,0,1,89,1
Bacteroides_vulgatus_57955,700023603,700038761,731,1902090,265010,1235937,266,222,32959,149902,251,136,232051,1086035,15,86,167990,3084676,5439,22832,426061,813,3,83,0,0,135,1
Bacteroides_vulgatus_57955,700023720,700023845,1467,1892776,263230,1229872,507,403,82922,384476,497,329,180308,845396,10,74,131496,2400333,4359,58707,1092687,2034,1,72,1,2,326,1
Bacteroides_vulgatus_57955,700023720,700037284,873,1903937,265519,1237084,324,206,39563,181104,308,170,225956,1055980,16,36,163590,2998920,5430,27204,515166,942,0,36,0,1,169,0
Bacteroides_vulgatus_57955,700023720,SRR413688,458,2013562,281465,1308585,158,127,25026,116911,152,100,256439,1191674,6,27,183578,3385408,6036,17731,332378,624,0,27,0,1,99,0
Bacteroides_vulgatus_57955,700023845,700037284,1789,1868736,259984,1214162,626,473,78734,363953,588,365,181250,850209,38,108,132553,2413619,4455,55142,1034854,1863,0,106,2,2,363,0
Bacteroides_vulgatus_57955,700023845,SRR413688,1736,1895961,263737,1231955,614,458,82624,382913,601,384,181113,849042,13,74,132199,2410574,4353,58271,1088428,2040,1,72,1,1,382,1
Bacteroides_vulgatus_57955,700023872,SRR413661,1491,1935937,270042,1257976,537,340,66023,306318,524,279,204019,951658,13,61,147616,2702450,4908,46371,870996,1587,0,61,0,2,277,0
Bacteroides_vulgatus_57955,700024233,700033989,895,1919216,267596,1247147,329,251,44093,202195,318,199,223503,1044952,11,52,161677,2968061,5118,30635,574912,1038,1,51,0,2,197,0
Bacteroides_vulgatus_57955,700024233,700111439,1775,1925359,268184,1251133,671,460,91145,420994,651,389,177039,830139,20,71,128839,2357294,4284,64119,1196709,2154,0,70,1,3,386,0
Bacteroides_vulgatus_57955,700024233,700123827,1850,1934154,269463,1256839,699,479,93775,432283,677,418,175688,824556,22,61,128206,2341241,4221,65638,1228973,2238,0,61,0,3,415,0
Bacteroides_vulgatus_57955,700024233,700164354,1468,1924813,268257,1250808,539,398,78875,362935,512,333,189382,887873,27,65,137831,2521210,4578,54993,1032006,1806,4,61,0,2,331,0
Bacteroides_vulgatus_57955,700024349,SRR341691,2266,1913135,266549,1243031,856,556,82234,382489,829,459,184315,860542,27,97,133324,2443922,4380,58452,1087071,1944,1,96,0,3,455,1
Bacteroides_vulgatus_57955,700024349,SRR413658,1572,1915888,267003,1244865,579,395,50061,232570,546,285,216942,1012295,33,110,156739,2875007,5139,35310,661212,1188,1,109,0,2,283,0
Bacteroides_vulgatus_57955,700024545,700037008,384,1404721,194688,912703,140,117,20834,96434,127,97,173854,816269,13,20,126823,2318042,3942,14824,273974,504,1,19,0,0,97,0
Bacteroides_vulgatus_57955,700024545,700116296,132,1399452,194095,909266,50,32,592,2920,7,1,193503,906346,43,31,140488,2574185,4365,520,8219,21,0,30,1,0,1,0
Bacteroides_vulgatus_57955,700024545,ERR911961,570,1417364,196451,920906,206,120,5962,27239,191,84,190489,893667,15,36,138872,2537887,4242,3964,77630,123,0,36,0,0,84,0
Bacteroides_vulgatus_57955,700024711,ERR912159,1071,1978200,276017,1285602,378,281,41092,187142,348,194,234925,1098460,30,87,169948,3119831,5601,28189,532187,1050,0,87,0,3,191,0
Bacteroides_vulgatus_57955,700024752,700032222,1302,1913400,266121,1243099,480,323,56642,261936,459,237,209479,981163,21,86,152674,2785712,5103,39513,744924,1371,0,86,0,0,237,0
Bacteroides_vulgatus_57955,700032068,700101581,1276,1476382,205418,959391,489,326,47209,219948,412,213,158209,739443,77,113,114615,2100330,3384,33936,624906,1002,1,112,0,0,213,0
Bacteroides_vulgatus_57955,700032222,700095213,1657,1911826,266171,1242127,611,411,96832,453338,598,341,169339,788789,13,70,121657,2240621,4089,70151,1287526,2337,0,70,0,0,341,0
Bacteroides_vulgatus_57955,700032944,ERR911959,2249,1880111,262667,1221726,794,623,93856,437785,768,495,168811,783941,26,128,120422,2227522,3879,67692,1243626,2037,1,125,2,3,491,1
Bacteroides_vulgatus_57955,700033502,700035861,1820,1989870,278207,1293283,657,468,46166,209337,642,396,232041,1083946,15,72,167715,3078855,5268,31187,595783,1041,3,69,0,1,395,0
Bacteroides_vulgatus_57955,700033502,700097688,1515,1890132,263585,1228178,555,360,31526,142731,540,298,232059,1085447,15,62,167876,3082894,5571,21273,406227,693,2,60,0,1,297,0
Bacteroides_vulgatus_57955,700033502,700161342,920,1915530,267113,1244692,297,253,35459,161102,282,186,231654,1083590,15,67,167620,3077618,5532,23929,458585,792,2,65,0,2,184,0
Bacteroides_vulgatus_57955,700033502,ERR912145,1307,1992342,278181,1294859,456,317,40823,186120,438,249,237358,1108739,18,68,171211,3149402,5604,27982,529457,921,2,66,0,1,248,0
Bacteroides_vulgatus_57955,700033797,700106198,1578,1880820,261690,1222150,580,371,65998,306383,558,301,195692,915767,22,70,142476,2600214,4611,46416,871254,1479,1,69,0,1,300,0
Bacteroides_vulgatus_57955,700033797,700113810,1930,1897351,264304,1232988,707,465,85585,396484,687,382,178719,836504,20,83,130089,2375274,4149,60081,1127439,1932,0,82,1,0,382,0
Bacteroides_vulgatus_57955,700033797,700116148,1616,1886349,262733,1225823,597,388,74179,343484,576,308,188554,882339,21,80,137266,2505338,4413,51780,976977,1695,0,80,0,0,308,0
Bacteroides_vulgatus_57955,700033922,700113705,634,1934638,269612,1257202,237,154,35475,166520,229,126,234137,1090682,8,28,168383,3098029,5634,25527,473220,813,0,28,0,0,125,1
Bacteroides_vulgatus_57955,700033922,SRR341721,701,1934707,269411,1257225,266,159,35150,164713,263,133,234261,1092512,3,26,168914,3102955,5667,25177,468167,795,0,26,0,0,132,1
Bacteroides_vulgatus_57955,700033922,SRR413643,702,1942451,270717,1262287,269,163,34771,162966,263,135,235946,1099321,6,28,169830,3122454,5679,24894,463218,786,0,28,0,1,133,1
Bacteroides_vulgatus_57955,700033989,700105312,1212,1913083,266805,1243092,445,295,61693,284611,417,229,205112,958481,28,66,148506,2722092,4845,43253,809311,1269,0,66,0,1,228,0
Bacteroides_vulgatus_57955,700033989,700111439,1059,1914216,266898,1243893,388,266,48851,225380,359,186,218047,1018513,29,80,157715,2892721,5103,34134,640959,1047,0,79,1,0,186,0
Bacteroides_vulgatus_57955,700033989,700116865,1552,1908418,266262,1240111,558,393,82735,382919,530,322,183527,857192,28,71,133195,2434178,4203,58092,1088736,1929,0,71,0,0,322,0
Bacteroides_vulgatus_57955,700033989,700123827,1133,1921365,267960,1248531,416,285,55207,254151,388,217,212753,994380,28,68,154072,2824130,4938,38476,722759,1218,0,68,0,0,217,0
Bacteroides_vulgatus_57955,700033989,700164354,789,1913863,266957,1243668,278,209,38085,174660,241,135,228872,1069008,37,74,165494,3036181,5349,26276,496933,771,3,71,0,0,135,0
Bacteroides_vulgatus_57955,700033989,700172279,1213,1915417,267151,1244590,446,294,56825,262137,411,221,210326,982453,35,73,152178,2790216,4965,39797,745438,1176,0,73,0,1,220,0
Bacteroides_vulgatus_57955,700034254,700035785,2191,1936594,270240,1258457,790,550,100694,465628,776,478,169546,792829,14,72,123259,2251301,3927,70700,1323850,2334,0,72,0,3,474,1
Bacteroides_vulgatus_57955,700034254,700103479,488,1924260,268258,1250420,143,166,18059,82173,133,115,250199,1168247,10,51,180696,3318138,5907,12160,233945,414,0,50,1,0,115,0
Bacteroides_vulgatus_57955,700034794,700111745,1514,1899688,264610,1234340,546,381,60458,283350,527,314,204152,950990,19,67,147138,2700990,4842,43200,805332,1518,2,65,0,4,310,0
Bacteroides_vulgatus_57955,700034794,700161872,664,1919601,267477,1247357,226,183,26135,121509,209,125,241342,1125848,17,58,173979,3197820,5745,18325,345509,693,3,55,0,1,124,0
Bacteroides_vulgatus_57955,700034794,700163811,646,1911939,266467,1242363,218,186,28285,132286,205,130,238182,1110077,13,56,171449,3153124,5658,19982,376120,756,3,53,0,1,129,0
Bacteroides_vulgatus_57955,700034794,700172498,1328,1903291,265053,1236736,472,352,53146,246229,438,256,211907,990507,34,96,153139,2813315,5067,37618,699734,1335,1,95,0,2,254,0
Bacteroides_vulgatus_57955,700034794,ERR912110,1518,1918493,267290,1246608,564,376,58949,276535,546,318,208341,970073,18,58,149932,2755331,4956,42298,785828,1479,1,57,0,3,315,0
Bacteroides_vulgatus_57955,700034794,ERR912135,2453,1913105,266559,1243077,938,565,79798,372370,923,504,186761,870707,15,61,135199,2472407,4515,56428,1058792,1890,2,59,0,1,503,0
Bacteroides_vulgatus_57955,700035157,ERR912089,664,1902514,265314,1236234,236,199,10065,46479,210,97,255249,1189755,26,102,183360,3379884,6021,7062,132144,231,4,98,0,1,96,0
Bacteroides_vulgatus_57955,700035533,700037008,393,1434260,199321,931900,139,119,19443,89778,125,88,179878,842122,14,31,130647,2391654,4065,13724,255160,450,1,30,0,0,88,0
Bacteroides_vulgatus_57955,700035533,ERR911961,566,1456531,202665,946412,204,121,6145,27823,182,85,196520,918589,22,36,142463,2608978,4326,3992,79351,126,0,36,0,0,85,0
Bacteroides_vulgatus_57955,700035785,700103479,1992,1947597,271608,1265565,720,507,86504,400901,698,432,185104,864664,22,75,134141,2455441,4410,61038,1139673,1992,0,74,1,3,429,0
Bacteroides_vulgatus_57955,700035861,700097688,1492,1899869,265374,1234529,563,354,24724,113513,552,310,240650,1121016,11,44,172911,3184662,5475,17199,322713,627,3,41,0,0,310,0
Bacteroides_vulgatus_57955,700035861,700161342,1177,1911443,266884,1242112,431,292,25643,117664,420,237,241241,1124448,11,55,173331,3194493,5520,17755,334622,615,4,51,0,0,237,0
Bacteroides_vulgatus_57955,700035861,ERR912145,1674,2006406,280699,1304047,629,392,37689,172004,615,334,243010,1132043,14,58,174774,3215862,5493,25791,489363,858,3,55,0,1,333,0
Bacteroides_vulgatus_57955,700037008,700106465,391,1458150,202193,947500,141,120,21772,100591,128,95,180421,846909,13,25,131703,2405004,4020,15436,285809,528,2,23,0,0,95,0
Bacteroides_vulgatus_57955,700037008,700108840,486,1515905,210392,985176,178,139,23380,108034,166,111,187012,877142,12,28,136097,2491375,3954,16497,307095,510,1,27,0,0,111,0
Bacteroides_vulgatus_57955,700037008,700116296,537,1469301,204123,954858,199,139,21816,100721,144,99,182307,854137,55,40,132417,2426004,3990,15434,286231,498,1,39,0,0,99,0
Bacteroides_vulgatus_57955,700037008,ERR911961,836,1521163,211044,988533,303,202,22024,101736,286,166,189020,886797,17,36,137531,2518816,4044,15602,289105,501,1,35,0,0,166,0
Bacteroides_vulgatus_57955,700037008,ERR911977,478,1520925,211035,988337,173,134,23451,108430,162,111,187584,879907,11,23,136487,2499217,4017,16580,308176,534,1,22,0,0,111,0
Bacteroides_vulgatus_57955,700037008,ERR911999,497,1527357,211998,992531,181,146,21331,98683,165,106,190667,893848,16,40,138684,2538705,4155,15101,280465,483,2,38,0,0,106,0
Bacteroides_vulgatus_57955,700037042,ERR911986,104,1430777,198636,929689,29,37,526,2257,22,7,198110,927432,7,30,143984,2633812,4500,308,6436,27,4,26,0,0,7,0
Bacteroides_vulgatus_57955,700037090,SRR413661,2118,2042044,285415,1327216,797,485,63400,294184,765,384,222015,1033032,32,101,159222,2934549,5325,44925,836265,1362,0,101,0,1,383,0
Bacteroides_vulgatus_57955,700037284,SRR413688,1018,1907688,266107,1239534,367,244,53638,246516,354,201,212469,993018,13,43,154272,2819778,5004,36837,701349,1362,0,43,0,0,201,0
Bacteroides_vulgatus_57955,700037649,700096865,452,1957463,273109,1271972,132,151,10991,51290,129,91,262118,1220682,3,60,188373,3467445,6228,7548,146049,273,1,59,0,1,90,0
Bacteroides_vulgatus_57955,700037649,ERR912048,1811,1937422,270097,1258941,671,461,89740,415422,650,380,180357,843519,21,81,130863,2395371,4323,63153,1180917,2196,1,80,0,3,377,0
Bacteroides_vulgatus_57955,700037649,SRR341696,391,1948520,271488,1266128,127,119,12313,57928,119,78,259175,1208200,8,41,186669,3431709,6222,8555,164905,324,0,41,0,1,77,0
Bacteroides_vulgatus_57955,700037649,SRR413665,396,1957762,273111,1272160,126,122,11903,56216,119,77,261208,1215944,7,45,187610,3453994,6228,8341,159995,312,0,45,0,1,76,0
Bacteroides_vulgatus_57955,700037852,SRR413758,273,1890672,262973,1228454,103,67,9759,45019,90,46,253214,1183435,13,21,183031,3361154,6120,6763,128021,273,2,19,0,0,46,0
Bacteroides_vulgatus_57955,700038386,700105153,468,1883231,261565,1223753,157,124,12136,55969,150,90,249429,1167784,7,34,180677,3316705,5970,8587,158999,321,3,31,0,1,89,0
Bacteroides_vulgatus_57955,700038386,700161342,2341,1889984,262634,1228152,851,517,91233,424216,827,442,171401,803936,24,75,124726,2282978,4104,64793,1205695,2160,3,72,0,1,441,0
Bacteroides_vulgatus_57955,700038386,700167759,850,1907424,265222,1239600,288,217,34339,160002,282,186,230883,1079598,6,31,166705,3066698,5391,24555,454593,858,2,29,0,1,185,0
Bacteroides_vulgatus_57955,700038386,SRR341632,956,1974525,273968,1283213,334,235,35679,166304,324,194,238289,1116909,10,41,172968,3172200,5559,25647,472362,903,2,39,0,1,193,0
Bacteroides_vulgatus_57955,700038386,SRR341704,2705,1987601,276677,1291810,1041,563,74290,345694,1020,503,202387,946116,21,60,146504,2686972,4872,52832,982645,1605,2,58,0,2,501,0
Bacteroides_vulgatus_57955,700038386,SRR413579,1000,1990338,277093,1293568,353,239,36859,171064,342,197,240234,1122504,11,42,173367,3188595,5550,26238,486018,936,1,41,0,1,196,0
Bacteroides_vulgatus_57955,700038386,SRR413601,1014,1990081,277038,1293398,348,254,35026,162626,337,200,242012,1130772,11,54,174669,3212037,5610,24927,462075,876,2,52,0,1,199,0
Bacteroides_vulgatus_57955,700038386,SRR413647,1119,1989841,277030,1293245,437,257,34967,161587,421,190,242063,1131658,16,67,175061,3214237,5676,24478,459470,813,2,65,0,3,187,0
Bacteroides_vulgatus_57955,700096865,SRR341696,322,2033249,283895,1321417,103,114,7424,34072,94,52,276471,1287345,9,62,198431,3657085,6519,5019,97044,153,1,61,0,0,52,0
Bacteroides_vulgatus_57955,700096865,SRR413665,319,2043438,285670,1328090,100,113,7473,34272,93,51,278197,1293818,7,62,199176,3675765,6513,5054,97609,153,1,61,0,0,51,0
Bacteroides_vulgatus_57955,700097688,700161342,929,1885159,262836,1224979,345,220,8654,40016,336,177,254182,1184963,9,43,182644,3366167,6078,5966,113875,207,3,40,0,0,177,0
Bacteroides_vulgatus_57955,700097688,ERR912145,1239,1902119,265324,1235963,476,266,18345,84337,464,224,246979,1151626,12,42,177734,3271270,5874,12630,239952,429,2,40,0,1,223,0
Bacteroides_vulgatus_57955,700097688,SRR341624,2186,1901336,264786,1235423,848,499,65416,303621,825,423,199370,931802,23,76,144088,2646536,4782,46526,862783,1554,1,75,0,0,421,2
Bacteroides_vulgatus_57955,700097688,SRR341648,2150,1891971,263210,1229274,841,488,63375,294489,813,417,199835,934785,28,71,144665,2654884,4806,45218,836752,1497,0,71,0,0,415,2
Bacteroides_vulgatus_57955,700098867,700106754,416,1988075,277610,1292005,152,111,10740,49841,135,65,266870,1242164,17,46,191162,3529039,6291,7617,141684,222,1,45,0,0,65,0
Bacteroides_vulgatus_57955,700098867,ERR912048,1212,1964397,274134,1276510,412,330,53534,247916,391,259,220600,1028594,21,71,159082,2921516,5184,37455,704997,1296,1,70,0,3,256,0
Bacteroides_vulgatus_57955,700098867,SRR413594,1202,1988172,277614,1292079,433,314,43267,198798,401,233,234347,1093281,32,81,168700,3105566,5577,30085,565379,930,1,80,0,1,232,0
Bacteroides_vulgatus_57955,700098867,donald4-11-30-0_,1594,1987249,277435,1291469,578,382,65312,301797,550,303,212123,989672,28,79,152710,2811197,5109,46003,857993,1395,0,79,0,2,301,0
Bacteroides_vulgatus_57955,700099512,ERR912068,103,1388327,192392,902071,33,33,738,3369,31,20,191654,898702,2,13,139463,2552320,4323,541,9551,15,0,13,0,0,20,0
Bacteroides_vulgatus_57955,700099512,ERR912161,100,1448187,200772,941073,32,34,718,3284,28,21,200054,937789,4,13,145309,2663696,4362,524,9313,15,0,13,0,0,21,0
Bacteroides_vulgatus_57955,700100022,ERR912000,817,1497031,208010,972819,270,254,49990,232676,253,156,158020,740143,17,98,114951,2102076,3402,35750,661165,1113,0,98,0,0,156,0
Bacteroides_vulgatus_57955,700100022,ERR912197,954,1488772,206739,967492,319,296,56768,263929,291,198,149971,703563,28,98,109142,1998337,3210,40774,749783,1230,0,98,0,0,198,0
Bacteroides_vulgatus_57955,700100022,SRR413593,780,1480130,205498,961955,262,241,45912,213459,237,133,159586,748496,25,108,116127,2125935,3426,32923,606479,975,0,108,0,0,133,0
Bacteroides_vulgatus_57955,700100022,SRR413666,786,1484303,206215,964620,266,243,48300,225196,247,148,157915,739424,19,95,114801,2100162,3309,34580,639955,1053,2,93,0,0,148,0
Bacteroides_vulgatus_57955,700101581,ERR912199,1569,1401010,194670,910215,585,345,29995,138484,529,249,164675,771731,56,96,120321,2191179,3693,20968,393809,675,1,95,0,0,248,1
Bacteroides_vulgatus_57955,700105153,700167759,439,1902010,265172,1235945,138,129,22017,102445,134,102,243155,1133500,4,27,174846,3219912,5742,15635,291127,573,3,24,0,0,102,0
Bacteroides_vulgatus_57955,700105153,SRR341632,443,1893335,262796,1230214,140,133,22459,104888,131,101,240337,1125326,9,32,174348,3195867,5763,16103,297967,594,2,30,0,0,101,0
Bacteroides_vulgatus_57955,700105153,SRR341704,2526,1909402,266156,1240758,950,559,76343,354611,927,478,189813,886147,23,81,137027,2516731,4683,54302,1007833,1698,2,79,0,1,477,0
Bacteroides_vulgatus_57955,700105153,SRR413579,461,1912410,266618,1242685,153,130,23840,110701,145,102,242778,1131984,8,28,174683,3215509,5760,16928,314533,642,2,26,0,0,102,0
Bacteroides_vulgatus_57955,700105153,SRR413601,475,1912304,266602,1242629,151,146,23196,107794,145,108,243406,1134835,6,38,175179,3223536,5790,16438,306332,612,3,35,0,0,108,0
Bacteroides_vulgatus_57955,700105153,SRR413647,1170,1911854,266568,1242327,440,293,38646,179153,420,233,227922,1063174,20,60,164277,3019812,5433,27257,509251,951,2,58,0,2,231,0
Bacteroides_vulgatus_57955,700105312,700111439,250,1933262,269483,1256235,89,74,16931,79248,79,50,252552,1176987,10,24,181388,3343462,6111,12289,225143,312,0,24,0,1,49,0
Bacteroides_vulgatus_57955,700105312,700116865,979,1926037,268627,1251523,357,240,55552,257529,347,205,213075,993994,10,35,153676,2823152,5154,39286,732050,1251,0,35,0,1,204,0
Bacteroides_vulgatus_57955,700105312,700123827,464,1939834,270435,1260499,168,120,26020,121147,157,91,244415,1139352,11,29,175605,3236535,5916,18723,344196,522,0,29,0,1,90,0
Bacteroides_vulgatus_57955,700105312,700164354,1250,1927914,268881,1252748,472,325,61382,284812,433,254,207499,967936,39,71,149364,2749350,5094,43701,809457,1278,3,68,0,1,253,0
Bacteroides_vulgatus_57955,700106198,700113810,1007,1898204,263929,1233424,343,275,45842,211710,336,224,218087,1021714,7,51,158948,2900887,5307,31752,602349,1029,1,49,1,1,223,0
Bacteroides_vulgatus_57955,700106198,700116148,640,1891584,262976,1229151,223,174,28644,132487,209,127,234332,1096664,14,47,170356,3113915,5721,19655,377155,651,1,46,0,1,126,0
Bacteroides_vulgatus_57955,700106465,700116296,139,1445241,200666,939178,54,30,642,3135,9,1,200024,936043,45,29,145088,2658589,4452,559,8825,21,1,27,1,0,1,0
Bacteroides_vulgatus_57955,700106465,ERR911961,571,1478982,205139,961123,208,122,6372,28937,193,85,198767,932186,15,37,144923,2647261,4374,4186,82484,141,1,36,0,0,85,0
Bacteroides_vulgatus_57955,700106754,700117537,1870,1975776,275662,1283948,671,493,87013,401685,647,407,188649,882263,24,86,136902,2505348,4539,60787,1142225,2043,2,84,0,4,403,0
Bacteroides_vulgatus_57955,700106754,700122408,509,2042402,285549,1327414,185,138,12507,57755,171,93,273042,1269659,14,45,195329,3607246,6402,8767,164240,258,1,44,0,0,93,0
Bacteroides_vulgatus_57955,700106754,ERR912048,939,1984193,276921,1289375,298,282,37739,173902,278,213,239182,1115473,20,69,172526,3168202,5691,26096,494665,945,2,67,0,3,210,0
Bacteroides_vulgatus_57955,700106754,SRR413594,1028,2043756,285668,1328295,346,300,37073,169724,320,228,248595,1158571,26,72,178765,3291062,5886,25524,482808,840,2,70,0,1,227,0
Bacteroides_vulgatus_57955,700106754,donald4-11-30-0_,1493,2038991,284871,1325189,529,373,47983,221161,501,290,236888,1104028,28,83,170063,3136357,5664,33821,628606,1056,2,81,0,2,288,0
Bacteroides_vulgatus_57955,700107566,700113867,2893,1949954,272425,1267257,1051,700,110013,511295,1042,644,162412,755962,9,56,116727,2147196,3963,78416,1452997,2472,0,56,0,4,640,0
Bacteroides_vulgatus_57955,700107566,700116468,304,1991487,278063,1294222,110,103,11855,55812,91,38,266208,1238410,19,65,190443,3518388,6399,8766,158469,201,1,64,0,0,38,0
Bacteroides_vulgatus_57955,700108840,700116296,165,1502904,208991,976846,71,38,280,1233,17,3,208711,975613,54,35,150822,2771580,4437,185,3502,12,0,35,0,0,3,0
Bacteroides_vulgatus_57955,700108840,ERR911961,787,1926871,268952,1252764,295,156,7960,35931,272,112,260992,1216833,23,44,187540,3457607,5352,5211,102432,150,0,44,0,0,112,0
Bacteroides_vulgatus_57955,700109449,ERR912132,1798,2028194,283433,1318200,672,392,63194,293028,660,315,220239,1025172,12,77,157987,2912360,5169,44862,832770,1452,2,75,0,1,314,0
Bacteroides_vulgatus_57955,700111296,SRR341723,138,2022018,282339,1314141,39,49,3782,17915,31,23,278557,1296226,8,26,199577,3682567,6534,2750,50911,84,0,26,0,0,23,0
Bacteroides_vulgatus_57955,700111439,700116865,776,1929140,268987,1253615,271,204,37992,175697,264,159,230995,1077918,7,45,166620,3061644,5490,26627,499513,951,0,45,0,0,159,0
Bacteroides_vulgatus_57955,700111439,700123827,262,1940440,270449,1260964,84,84,9010,41592,76,44,261439,1219372,8,40,188007,3463842,6267,6392,118174,210,0,39,1,0,44,0
Bacteroides_vulgatus_57955,700111439,700164354,1157,1926624,268638,1251966,429,313,60221,279272,396,237,208417,972694,33,76,150245,2762761,5076,42705,793785,1326,3,73,0,0,237,0
Bacteroides_vulgatus_57955,700111439,700172279,247,1936237,269949,1258174,88,73,18064,84355,78,50,251885,1173819,10,23,180895,3334451,6111,13069,239651,345,0,23,0,1,49,0
Bacteroides_vulgatus_57955,700111745,700161872,1368,1926041,268673,1251601,485,349,53939,251839,467,287,214734,999762,18,62,154514,2839714,5058,38249,715900,1368,3,59,0,3,284,0
Bacteroides_vulgatus_57955,700111745,700163811,1367,1920398,268024,1247903,478,353,54096,252681,468,293,213928,995222,10,60,153704,2826952,5010,38356,718301,1386,2,58,0,4,289,0
Bacteroides_vulgatus_57955,700111745,700172498,1623,1913657,266819,1243538,595,413,87931,410231,581,337,178888,833307,14,76,128731,2366963,4227,62828,1165678,2187,1,75,0,2,335,0
Bacteroides_vulgatus_57955,700111745,ERR912110,221,1940370,270829,1260922,50,91,5382,24134,33,22,265447,1236788,17,69,190606,3513440,6318,3512,68758,132,3,66,0,1,21,0
Bacteroides_vulgatus_57955,700111745,ERR912135,2305,1929751,269340,1253981,864,544,68262,318565,842,467,201078,935416,22,77,144173,2657164,4911,48845,905344,1506,3,74,0,2,465,0
Bacteroides_vulgatus_57955,700113705,700161743,1831,1925357,268257,1251168,639,462,92380,430835,625,396,175877,820333,14,66,127073,2329825,4101,65892,1224342,2271,1,65,0,0,396,0
Bacteroides_vulgatus_57955,700113810,700116148,551,1920260,267645,1247845,180,152,22443,102480,172,104,245202,1145365,8,48,176764,3253409,5922,15562,291407,471,0,47,1,0,104,0
Bacteroides_vulgatus_57955,700116296,ERR911961,759,1507248,209545,979613,289,152,9448,43144,226,95,200097,936469,63,57,145062,2660049,4296,6431,122806,195,0,57,0,0,95,0
Bacteroides_vulgatus_57955,700116296,ERR911977,179,1507330,209558,979638,73,35,320,1281,19,3,209238,978357,54,32,151267,2779310,4494,189,3648,6,0,32,0,0,3,0
Bacteroides_vulgatus_57955,700116296,ERR911999,227,1513446,210510,983624,95,45,480,2202,30,3,210030,981422,65,42,151765,2787986,4515,349,6248,9,1,41,0,0,3,0
Bacteroides_vulgatus_57955,700116865,700123827,609,1934616,269857,1257172,206,155,27652,127563,197,125,242205,1129609,9,30,174623,3208477,5727,19144,362816,729,0,30,0,0,125,0
Bacteroides_vulgatus_57955,700116865,700172279,978,1929143,269093,1253550,357,238,55978,259730,345,206,213115,993820,12,32,153616,2822690,5154,39644,738265,1281,0,32,0,1,205,0
Bacteroides_vulgatus_57955,700117395,ERR912020,2600,1969790,274675,1280047,967,643,101503,471622,964,599,173172,808425,3,44,125328,2295780,4167,71897,1340653,2316,2,42,0,2,596,1
Bacteroides_vulgatus_57955,700117537,ERR912048,1542,1951473,272131,1268094,565,381,75179,350096,533,306,196952,917998,32,75,142207,2607134,4653,53158,995249,1881,2,73,0,2,303,1
Bacteroides_vulgatus_57955,700117537,ERR912111,164,1977515,275859,1285108,57,61,3077,13993,41,15,272782,1271115,16,46,195733,3611114,6498,2170,39707,102,2,44,0,0,15,0
Bacteroides_vulgatus_57955,700117537,SRR413594,1635,1977106,275854,1284821,599,399,70787,327702,569,317,205067,957119,30,82,148158,2718336,4863,49687,931709,1710,2,80,0,3,314,0
Bacteroides_vulgatus_57955,700117537,donald4-11-30-0_,1812,1973430,275259,1282419,658,435,88631,411344,623,360,186628,871075,35,75,134767,2473979,4479,62757,1169190,2085,1,74,0,2,358,0
Bacteroides_vulgatus_57955,700117766,ERR912142,880,1409866,196026,916108,323,228,16166,75493,295,141,179860,840615,28,87,130604,2387272,3969,11519,214570,390,2,85,0,0,141,0
Bacteroides_vulgatus_57955,700117766,SRR341633,789,1346847,186673,875214,290,200,14860,69043,266,125,171813,806171,24,75,125680,2289023,3810,10485,196308,336,2,73,0,0,125,0
Bacteroides_vulgatus_57955,700122408,ERR912048,1347,1982406,276728,1288223,459,368,54312,250950,440,305,222416,1037273,19,63,160432,2946161,5226,37973,713560,1317,1,62,0,3,302,0
Bacteroides_vulgatus_57955,700122408,SRR413594,1373,2042017,285483,1327177,495,358,47949,219181,464,285,237534,1107996,31,73,171043,3147347,5598,33027,623472,1044,1,72,0,1,284,0
Bacteroides_vulgatus_57955,700122408,donald4-11-30-0_,1887,2037258,284707,1324071,688,452,69242,319249,662,370,215465,1004822,26,82,154957,2854355,5154,48696,907572,1479,2,80,0,2,368,0
Bacteroides_vulgatus_57955,700122765,ERR912032,2098,1973912,275654,1282904,776,487,89004,412599,753,387,186650,870305,23,100,134057,2472412,4446,63299,1172464,2034,2,98,0,0,386,1
Bacteroides_vulgatus_57955,700122765,ERR912087,1996,1973933,275630,1282885,745,447,87367,405188,724,365,188263,877697,21,82,135213,2493402,4476,62154,1151406,2004,2,80,0,1,363,1
Bacteroides_vulgatus_57955,700122765,ERR912192,2024,1978844,276319,1286078,749,465,91996,425588,732,377,184323,860490,17,88,132659,2444431,4380,65261,1209397,2106,2,86,0,2,374,1
Bacteroides_vulgatus_57955,700122765,SRR413560,1660,1978128,276219,1285637,623,392,68055,313173,594,321,208164,972464,29,71,150257,2762200,4935,47584,890393,1542,3,68,0,1,319,1
Bacteroides_vulgatus_57955,700123827,700164354,1250,1933401,269659,1256369,466,336,70249,325969,438,265,199410,930400,28,71,143824,2642555,4821,49759,926558,1590,3,68,0,0,265,0
Bacteroides_vulgatus_57955,700123827,700172279,461,1943000,270951,1262533,168,118,25998,121013,156,91,244953,1141520,12,27,175932,3242688,5940,18709,343796,534,0,27,0,1,90,0
Bacteroides_vulgatus_57955,700161219,ERR911968,1411,1523979,211958,990603,476,407,34791,160232,445,340,177167,830371,31,67,128384,2358994,3735,24447,455505,744,0,67,0,1,339,0
Bacteroides_vulgatus_57955,700161219,ERR912035,1700,1518617,211339,987142,585,478,36398,167589,559,411,174941,819553,26,67,126655,2328323,3681,25605,476391,771,0,67,0,1,410,0
Bacteroides_vulgatus_57955,700161219,ERR912100,1612,1529654,212760,994251,565,439,33387,156575,503,328,179373,837676,62,111,129302,2379853,3873,24051,444948,726,0,111,0,1,327,0
Bacteroides_vulgatus_57955,700161219,ERR912201,1535,1445109,200676,939236,526,447,37938,174912,495,378,162738,764324,31,69,118764,2170674,3534,26511,497343,882,0,69,0,1,377,0
Bacteroides_vulgatus_57955,700161219,SRR341638,1447,1478133,204872,960889,514,377,29064,135799,467,288,175808,825090,47,89,127657,2343866,3747,20862,385920,615,0,89,0,1,287,0
Bacteroides_vulgatus_57955,700161219,SRR341714,1408,1509181,209606,980961,473,408,35052,161551,443,340,174554,819410,30,68,126922,2327618,3690,24671,459238,744,0,68,0,1,339,0
Bacteroides_vulgatus_57955,700161219,SRR413585,1426,1508762,209747,980789,487,415,35154,161676,459,353,174593,819113,28,62,126752,2326978,3609,24608,459661,759,0,62,0,1,352,0
Bacteroides_vulgatus_57955,700161219,SRR413603,1540,1515146,210714,984839,536,417,27515,128305,480,310,183199,856534,56,107,132461,2433307,3834,19512,364842,561,0,107,0,1,309,0
Bacteroides_vulgatus_57955,700161219,SRR413610,1536,1498747,208681,974273,536,401,26489,123057,483,307,182192,851216,53,94,131434,2418470,3744,18614,350023,534,0,94,0,1,306,0
Bacteroides_vulgatus_57955,700161342,ERR912145,585,1917237,267385,1245829,203,150,17439,79893,191,109,249946,1165936,12,41,179737,3312116,5955,11940,227328,411,3,38,0,1,108,0
Bacteroides_vulgatus_57955,700161342,SRR341624,1615,1916091,266755,1245042,598,392,69481,323300,577,329,197274,921742,21,63,142277,2618212,4737,49640,918601,1659,2,61,0,0,327,2
Bacteroides_vulgatus_57955,700161342,SRR341648,1574,1903231,264667,1236622,589,381,68887,320659,565,324,195780,915963,24,57,141533,2601646,4710,49320,911016,1641,2,55,0,0,322,2
Bacteroides_vulgatus_57955,700161429,ERR912153,2452,2044771,285811,1328983,924,554,89869,416400,904,488,195942,912583,20,66,141234,2591913,4602,63110,1183978,2112,1,65,0,0,487,1
Bacteroides_vulgatus_57955,700161743,700164249,1840,1916025,266928,1245043,626,485,96346,446261,598,382,170582,798782,28,103,124231,2268089,4026,67817,1268641,2325,0,103,0,0,381,1
Bacteroides_vulgatus_57955,700161743,SRR341721,1943,1935999,269604,1258045,678,487,84721,395225,665,409,184883,862820,13,78,133587,2450499,4374,60517,1123130,2028,1,77,0,0,409,0
Bacteroides_vulgatus_57955,700161743,SRR413643,1969,1944048,270952,1263321,691,492,85614,399393,670,415,185338,863928,21,77,133662,2453760,4362,61113,1135023,2043,1,76,0,1,414,0
Bacteroides_vulgatus_57955,700161872,700163811,57,1942839,271255,1262556,21,16,479,2121,8,3,270776,1260435,13,13,193863,3580953,6489,351,6006,6,1,12,0,0,3,0
Bacteroides_vulgatus_57955,700161872,700172498,1294,1929511,269124,1253875,453,339,55952,259093,432,262,213172,994782,21,77,153686,2825614,5046,39445,736406,1428,2,75,0,1,261,0
Bacteroides_vulgatus_57955,700161872,ERR912110,1430,1954030,272726,1269864,525,357,52787,246611,507,303,219939,1023253,18,54,157960,2906606,5193,37544,700963,1326,2,52,0,2,301,0
Bacteroides_vulgatus_57955,700161872,ERR912135,2297,1948473,271957,1266228,879,537,65530,304983,856,472,206427,961245,23,65,148920,2729835,4980,45957,867480,1512,3,62,0,0,472,0
Bacteroides_vulgatus_57955,700163811,700172498,1287,1922039,268163,1248977,443,345,51124,236946,421,258,217039,1012031,22,87,156218,2874757,5118,36038,673471,1329,2,85,0,1,257,0
Bacteroides_vulgatus_57955,700163811,ERR912110,1407,1949613,272214,1266921,511,353,51821,242127,492,299,220393,1024794,19,54,158103,2911083,5196,36808,688259,1314,1,53,0,3,296,0
Bacteroides_vulgatus_57955,700163811,ERR912135,2239,1943971,271427,1263227,844,525,64002,297841,826,463,207425,965386,18,62,149536,2741633,4989,44754,847275,1494,3,59,0,0,463,0
Bacteroides_vulgatus_57955,700164354,700172279,1248,1931478,269435,1255032,472,324,63324,293102,433,252,206111,961930,39,72,148586,2732164,5040,44820,833133,1353,3,69,0,1,251,0
Bacteroides_vulgatus_57955,700167759,SRR341704,2745,1934462,269940,1257185,1036,605,90738,421872,1015,543,179202,835313,21,62,128834,2372788,4317,64533,1199046,2037,2,60,0,0,543,0
Bacteroides_vulgatus_57955,700167759,SRR413647,1533,1936821,270334,1258687,562,380,61117,282939,550,330,209217,975748,12,50,150511,2771831,4902,43058,804298,1461,2,48,0,1,329,0
Bacteroides_vulgatus_57955,700172498,ERR912110,1807,1941694,270876,1261809,665,436,72985,338309,642,359,197891,923500,23,77,143146,2622608,4746,51168,961986,1773,0,77,0,1,358,0
Bacteroides_vulgatus_57955,ERR911961,ERR911977,770,1942186,271037,1262591,289,147,8834,39801,266,110,262203,1222790,23,37,188443,3474464,5463,5804,113419,180,0,37,0,0,110,0
Bacteroides_vulgatus_57955,ERR911961,ERR911999,798,1943886,271274,1263692,299,164,8985,40472,274,115,262289,1223220,25,49,188573,3475636,5451,5905,115331,180,2,47,0,0,115,0
Bacteroides_vulgatus_57955,ERR911968,ERR912035,503,1952403,272517,1269449,204,105,2202,10330,199,92,270315,1259119,5,13,193867,3577856,5634,1585,29363,42,0,13,0,0,92,0
Bacteroides_vulgatus_57955,ERR911968,ERR912100,1630,1957712,273218,1272864,583,424,69640,321813,541,324,203578,951051,42,100,147201,2701647,4305,48779,915223,1437,0,100,0,0,324,0
Bacteroides_vulgatus_57955,ERR911968,ERR912201,440,1551182,215103,1008150,184,89,1894,8904,180,82,213209,999246,4,7,154963,2838107,4668,1390,25286,36,0,7,0,0,82,0
Bacteroides_vulgatus_57955,ERR911986,ERR912181,118,1529745,212461,994074,33,43,657,2820,27,8,211804,991254,6,35,153707,2815399,4656,381,8049,30,1,34,0,0,8,0
Bacteroides_vulgatus_57955,ERR912000,ERR912197,376,1944189,271253,1263961,131,122,5488,24097,93,54,265765,1239864,38,68,191067,3523002,5523,3541,68633,117,0,68,0,0,54,0
Bacteroides_vulgatus_57955,ERR912004,ERR912093,93,2024485,283053,1315754,31,40,1889,8109,25,10,281164,1307645,6,30,201144,3715122,6669,1085,23206,36,1,28,1,0,10,0
Bacteroides_vulgatus_57955,ERR912004,mickey3-11-30-0_,103,2023450,282832,1315097,36,43,1889,8121,25,10,280943,1306976,11,33,201176,3713119,6633,1091,23227,45,2,30,1,0,10,0
Bacteroides_vulgatus_57955,ERR912020,ERR912061,660,2022608,282677,1314591,206,215,13685,63547,194,122,268992,1251044,12,93,192319,3554465,6348,9911,180427,303,2,91,0,3,119,0
Bacteroides_vulgatus_57955,ERR912020,ERR912131,851,2037152,284624,1323975,318,240,30189,140259,308,172,254435,1183716,10,68,182106,3363045,5997,21537,398532,708,0,68,0,1,171,0
Bacteroides_vulgatus_57955,ERR912032,ERR912087,190,2040211,285186,1326013,45,91,4259,20966,24,23,280927,1305047,21,68,200360,3708163,6618,3447,59313,138,2,66,0,1,22,0
Bacteroides_vulgatus_57955,ERR912032,ERR912192,205,2045018,285870,1329132,42,104,4259,20950,24,23,281611,1308182,18,81,200900,3717019,6627,3439,59273,138,3,78,0,1,22,0
Bacteroides_vulgatus_57955,ERR912035,ERR912100,2114,1952879,272667,1269768,772,523,71201,329017,728,421,201466,940751,44,102,145608,2672406,4239,49865,935707,1479,0,102,0,0,421,0
Bacteroides_vulgatus_57955,ERR912045,ERR912104,3724,1990349,278303,1293638,1356,859,90719,419519,1341,786,187584,874119,15,73,134858,2483077,4422,63889,1192604,2064,1,72,0,2,783,1
Bacteroides_vulgatus_57955,ERR912048,ERR912111,1589,1985804,277123,1290429,574,393,71753,332106,550,331,205370,958323,24,62,148573,2721473,4923,50202,944400,1716,3,59,0,1,330,0
Bacteroides_vulgatus_57955,ERR912048,donald4-11-30-0_,924,1984518,276919,1289590,328,212,33974,159113,308,178,242945,1130477,20,34,174492,3211188,5751,24187,452291,861,1,33,0,1,177,0
Bacteroides_vulgatus_57955,ERR912061,ERR912131,1133,2022919,282723,1314813,402,301,35882,166896,385,215,246841,1147917,17,86,176603,3261370,5778,25655,474181,852,0,86,0,6,209,0
Bacteroides_vulgatus_57955,ERR912100,ERR912201,1712,1551492,215238,1008367,621,439,58805,273608,586,350,156433,734759,35,89,114583,2086184,3510,41805,777744,1275,0,89,0,0,350,0
Bacteroides_vulgatus_57955,ERR912110,ERR912135,2654,2018590,282177,1311936,1027,594,71808,334506,1005,527,210369,977430,22,67,150424,2776814,5052,51294,950625,1599,1,66,0,2,525,0
Bacteroides_vulgatus_57955,ERR912137,ERR912163,939,1943565,271161,1263605,310,285,27031,126416,249,151,244130,1137189,61,134,175180,3231278,5109,19381,359288,579,0,134,0,0,151,0
Bacteroides_vulgatus_57955,SRR341624,ERR912145,2177,2012732,280740,1308067,822,501,76098,351338,798,420,204642,956729,24,81,147908,2717392,4887,53675,998608,1731,0,81,0,2,416,2
Bacteroides_vulgatus_57955,SRR341632,SRR413647,1762,2005519,279091,1303353,657,418,66480,308046,646,354,212611,995307,11,64,154176,2826813,4932,47035,875462,1641,2,62,0,2,352,0
Bacteroides_vulgatus_57955,SRR341638,ERR911968,1522,1870636,259948,1216439,544,366,61313,284348,518,286,198635,932091,26,80,144463,2647739,4071,43325,808426,1293,0,80,0,0,286,0
Bacteroides_vulgatus_57955,SRR341638,ERR912035,1904,1865471,259333,1213133,698,443,63111,292683,670,363,196222,920450,28,80,142585,2614751,4014,44640,832086,1323,0,80,0,0,363,0
Bacteroides_vulgatus_57955,SRR341638,ERR912100,232,1878354,261030,1221390,77,60,1791,7588,56,19,259239,1213802,21,41,187502,3448492,5412,1009,21707,48,0,41,0,0,19,0
Bacteroides_vulgatus_57955,SRR341638,ERR912201,1499,1493762,206440,971011,553,371,51368,240755,538,295,155072,730256,15,76,113662,2073773,3333,37177,683942,1146,0,76,0,0,295,0
Bacteroides_vulgatus_57955,SRR341638,SRR341714,1536,1853490,257190,1205259,539,366,61631,286197,514,292,195559,919062,25,74,142603,2610557,4026,43640,813649,1302,0,74,0,0,292,0
Bacteroides_vulgatus_57955,SRR341638,SRR413585,1442,1853321,257407,1205246,518,359,61664,285808,494,287,195743,919438,24,72,142476,2611878,3960,43505,812620,1299,0,72,0,0,287,0
Bacteroides_vulgatus_57955,SRR341638,SRR413603,213,1871130,260090,1216725,67,55,1791,7596,55,21,258299,1209129,12,34,186751,3435353,5283,1008,21729,51,0,34,0,0,21,0
Bacteroides_vulgatus_57955,SRR341638,SRR413610,184,1850853,257530,1203656,60,33,1782,7527,54,18,255748,1196129,6,15,184471,3398771,5145,990,21543,48,0,15,0,0,18,0
Bacteroides_vulgatus_57955,SRR341644,SRR413556,55,2018039,282080,1311694,12,29,639,2883,6,4,281441,1308811,6,25,201260,3718570,6603,489,8145,15,0,25,0,0,4,0
Bacteroides_vulgatus_57955,SRR341648,ERR912145,2093,1995462,277945,1296765,791,488,74793,345934,766,412,203152,950831,25,76,147154,2700473,4866,52985,983122,1695,0,76,0,2,408,2
Bacteroides_vulgatus_57955,SRR341691,SRR413658,1711,2020337,282152,1312978,635,454,52308,241318,610,388,229844,1071660,25,66,165539,3044032,5409,36443,686347,1164,1,64,1,0,388,0
Bacteroides_vulgatus_57955,SRR341701,SRR413596,1753,2025681,283183,1316574,689,411,69133,320244,670,340,214050,996330,19,71,153411,2830404,5175,49095,910161,1476,0,71,0,1,339,0
Bacteroides_vulgatus_57955,SRR341701,SRR413616,1178,2029612,283720,1319129,427,316,46140,215685,411,270,237580,1103444,16,46,170000,3134830,5502,32860,613055,1140,0,46,0,1,269,0
Bacteroides_vulgatus_57955,SRR341701,SRR413633,1700,2037393,284694,1324114,644,422,67060,311116,627,346,217634,1012998,17,76,155774,2877946,5274,47826,884091,1431,0,76,0,1,345,0
Bacteroides_vulgatus_57955,SRR341701,SRR413659,2915,2034858,284408,1322566,1129,587,50843,237152,1118,541,233565,1085414,11,46,167390,3083455,5397,36005,674203,1248,0,46,0,0,541,0
Bacteroides_vulgatus_57955,SRR341714,ERR911968,119,1920764,267375,1248805,35,37,1260,5646,25,11,266115,1243159,10,26,191886,3532071,5520,818,16099,21,0,26,0,0,11,0
Bacteroides_vulgatus_57955,SRR341714,ERR912035,579,1916265,266864,1245943,220,127,3583,16491,214,100,263281,1229452,6,27,189724,3493169,5463,2510,46897,66,0,27,0,0,100,0
Bacteroides_vulgatus_57955,SRR341714,ERR912100,1629,1921263,267494,1249131,570,419,61148,282358,521,319,206346,966773,49,100,150036,2745927,4356,42731,803101,1242,0,100,0,0,319,0
Bacteroides_vulgatus_57955,SRR341714,ERR912201,483,1532786,212266,996169,196,103,2364,11024,185,82,209902,985145,11,21,153053,2797801,4581,1706,31321,45,0,21,0,0,82,0
Bacteroides_vulgatus_57955,SRR341714,SRR413585,459,1905278,265213,1238855,162,95,3763,16155,158,72,261450,1222700,4,23,188824,3473939,5337,2236,46151,78,0,23,0,0,72,0
Bacteroides_vulgatus_57955,SRR341714,SRR413603,1569,1903371,265111,1237604,544,405,64015,296104,516,319,201096,941500,28,86,145925,2674537,4038,45006,841977,1329,0,86,0,0,319,0
Bacteroides_vulgatus_57955,SRR341714,SRR413610,1580,1884568,262778,1225559,549,396,63470,293467,520,315,199308,932092,29,81,144141,2648196,3939,44548,834554,1299,0,81,0,0,315,0
Bacteroides_vulgatus_57955,SRR413560,ERR912032,1664,2043069,285586,1327900,606,407,60658,281160,581,308,224928,1046740,25,99,161057,2973835,5328,43090,798974,1416,5,94,0,1,307,0
Bacteroides_vulgatus_57955,SRR413560,ERR912087,1579,2043219,285577,1327961,583,364,59623,277002,559,298,225954,1050959,24,66,161700,2985816,5361,42462,787149,1395,4,62,0,3,295,0
Bacteroides_vulgatus_57955,SRR413560,ERR912192,1610,2048115,286271,1331136,588,381,60783,282075,568,307,225488,1049061,20,74,161402,2980447,5334,43310,801490,1425,4,70,0,4,303,0
Bacteroides_vulgatus_57955,SRR413579,SRR413647,1821,2027051,283387,1317441,681,428,66338,305707,668,368,217049,1011734,13,60,156154,2874062,4986,46403,869089,1629,1,59,0,2,366,0
Bacteroides_vulgatus_57955,SRR413585,ERR911968,388,1922418,268028,1250070,140,83,2432,10149,137,62,265596,1239921,3,21,191198,3523180,5385,1319,29068,60,0,21,0,0,62,0
Bacteroides_vulgatus_57955,SRR413585,ERR912035,849,1917066,267422,1246617,331,170,4594,20264,327,147,262828,1226353,4,23,189033,3484725,5301,2868,57825,99,0,23,0,0,147,0
Bacteroides_vulgatus_57955,SRR413585,ERR912100,1698,1921992,267991,1249778,608,426,68639,316903,572,333,199352,932875,36,93,144549,2650002,4074,47945,901360,1404,0,93,0,0,333,0
Bacteroides_vulgatus_57955,SRR413585,ERR912201,636,1531232,212242,995283,252,140,3481,15652,249,126,208761,979631,3,14,152086,2782358,4449,2284,44576,96,0,14,0,0,126,0
Bacteroides_vulgatus_57955,SRR413585,SRR413603,1634,1907821,266119,1240665,582,410,63646,293907,551,324,202473,946758,31,86,146480,2689774,4020,44556,835854,1311,0,86,0,0,324,0
Bacteroides_vulgatus_57955,SRR413585,SRR413610,1636,1888595,263690,1228252,585,398,64492,297463,559,320,199198,930789,26,78,143747,2644738,3882,44976,846105,1308,0,78,0,0,320,0
Bacteroides_vulgatus_57955,SRR413593,ERR912197,362,1917878,267370,1246983,129,115,4405,18923,87,48,262965,1228060,42,67,189340,3489449,5391,2680,54008,81,0,67,0,0,48,0
Bacteroides_vulgatus_57955,SRR413594,ERR912048,572,1985498,277091,1290241,187,158,24551,115227,174,125,252540,1175014,13,33,181593,3337467,5982,17158,327884,639,3,29,1,1,124,0
Bacteroides_vulgatus_57955,SRR413594,ERR912111,1704,2041648,285281,1326926,622,407,72700,333926,590,331,212581,993000,32,76,153994,2819948,5058,50128,949979,1671,3,73,0,2,329,0
Bacteroides_vulgatus_57955,SRR413594,donald4-11-30-0_,965,2040778,285134,1326353,353,221,36987,170889,341,183,248147,1155464,12,38,178239,3282324,5829,25821,485967,879,3,35,0,1,182,0
Bacteroides_vulgatus_57955,SRR413596,SRR413616,2339,2014989,281905,1309690,915,543,104579,485849,904,491,177326,823841,11,52,127000,2340308,4215,74377,1380788,2382,0,52,0,2,489,0
Bacteroides_vulgatus_57955,SRR413596,SRR413633,568,2023606,282980,1315218,228,140,22168,102114,223,113,260812,1213104,5,27,186809,3446278,6225,15387,290511,444,0,27,0,0,113,0
Bacteroides_vulgatus_57955,SRR413601,SRR413647,1839,2027015,283366,1317437,679,445,65261,300853,666,372,218105,1016584,13,73,156874,2887850,5028,45674,855298,1587,2,71,0,2,370,0
Bacteroides_vulgatus_57955,SRR413603,ERR911968,1552,1930607,269495,1255434,548,406,63536,293651,519,314,205959,961783,29,92,148706,2732518,4125,44600,835042,1311,0,92,0,0,314,0
Bacteroides_vulgatus_57955,SRR413603,ERR912035,2001,1925577,268899,1252195,734,492,65598,303309,702,401,203301,948886,32,91,146595,2696025,4038,46184,862378,1365,0,91,0,0,401,0
Bacteroides_vulgatus_57955,SRR413603,ERR912201,1609,1532332,212591,996025,587,412,59333,276097,566,338,153258,719928,21,74,112357,2044163,3264,42136,784919,1236,0,74,0,0,338,0
Bacteroides_vulgatus_57955,SRR413605,SRR413637,1039,1961939,273562,1275035,416,210,32754,151691,412,182,240808,1123344,4,28,173269,3191006,5757,23263,431081,729,0,28,0,0,182,0
Bacteroides_vulgatus_57955,SRR413610,ERR911968,1554,1912312,267246,1243607,552,393,64484,297563,525,310,202762,946044,27,83,145992,2688174,3966,45060,846327,1302,0,83,0,0,310,0
Bacteroides_vulgatus_57955,SRR413610,ERR912035,2012,1907417,266689,1240474,740,481,66802,308361,713,399,199887,932113,27,82,143805,2648643,3891,46757,876967,1359,0,82,0,0,399,0
Bacteroides_vulgatus_57955,SRR413610,ERR912100,99,1920552,268447,1248905,35,40,139,708,8,2,268308,1248197,27,38,191743,3547475,5373,109,2015,0,0,38,0,0,2,0
Bacteroides_vulgatus_57955,SRR413610,ERR912201,1609,1516876,210673,986078,589,396,59077,274569,573,334,151596,711509,16,62,110795,2020555,3177,41826,780669,1212,0,62,0,0,334,0
Bacteroides_vulgatus_57955,SRR413616,SRR413633,2189,2026806,283422,1317296,830,530,97346,452874,817,464,186076,864422,13,66,133001,2455828,4437,69486,1286919,2217,0,66,0,2,462,0
Bacteroides_vulgatus_57955,SRR413616,SRR413659,2105,2029919,283796,1319397,821,396,15063,69345,817,361,268733,1250052,4,35,192529,3551348,6279,10364,197341,330,0,35,0,1,360,0
Bacteroides_vulgatus_57955,SRR413622,ERR911966,309,2040656,285128,1326319,103,91,8785,40850,88,56,276343,1285469,15,35,197725,3652157,6525,6311,116041,198,1,34,0,1,55,0
Bacteroides_vulgatus_57955,SRR413633,SRR413659,4172,2032217,284138,1320855,1625,870,108494,504667,1615,802,175644,816188,10,68,125774,2318614,4176,77253,1434270,2478,0,68,0,1,801,0
Bacteroides_vulgatus_57955,SRR413666,ERR912197,361,1925145,268605,1251627,128,112,5506,24229,94,51,263099,1227398,34,61,189143,3487711,5340,3545,69031,111,2,59,0,0,51,0
