species_name,sample 1,sample 2,core_diff,core_len,core_len_4D,core_len_1D,core_diff_4D,core_diff_1D,recomb_len_4D,recomb_len_1D,recomb_diff_4D,recomb_diff_1D,clonal_len_4D,clonal_len_1D,clonal_diff_4D,clonal_diff_1D,clonal_n,clonal_m,clonal_nn,recomb_n,recomb_m,recomb_nn,clonal_mut_n,clonal_mut_m,clonal_mut_nn,recomb_mut_n,recomb_mut_m,recomb_mut_nn
Bacteroides_ovatus_58035,700014562,700014724,589,926604,131763,604142,204,132,10563,48465,192,99,121200,555677,12,33,83465,1580962,2604,7383,137817,195,1,32,0,0,99,0
Bacteroides_ovatus_58035,700014562,700016000,599,928273,132054,605271,207,139,10573,48539,192,100,121481,556732,15,39,83556,1584045,2595,7403,138016,198,0,39,0,0,100,0
Bacteroides_ovatus_58035,700014562,700023113,554,934641,132875,609405,190,120,10721,49212,180,100,122154,560193,10,20,84164,1593784,2631,7477,139958,201,0,20,0,0,100,0
Bacteroides_ovatus_58035,700014562,700095213,554,925905,131694,603690,189,120,9673,44476,176,94,122021,559214,13,26,83971,1591064,2607,6792,126450,186,0,26,0,0,94,0
Bacteroides_ovatus_58035,700014562,700102043,554,926628,131822,604155,189,120,9676,44529,175,96,122146,559626,14,24,84025,1592246,2607,6797,126604,186,0,24,0,0,96,0
Bacteroides_ovatus_58035,700014562,700106170,571,927737,131953,604890,193,122,9298,42872,179,94,122655,562018,14,28,84414,1599027,2613,6561,121869,186,0,28,0,0,93,1
Bacteroides_ovatus_58035,700014562,700114082,561,925198,131516,603206,191,123,9027,41715,173,92,122489,561491,18,31,84319,1597532,2622,6430,118535,180,0,31,0,0,92,0
Bacteroides_ovatus_58035,700014562,700116468,593,928108,131906,605126,202,131,10867,49953,188,99,121039,555173,14,32,83453,1579474,2592,7557,142083,219,0,32,0,0,99,0
Bacteroides_ovatus_58035,700014562,700117239,584,928505,132037,605415,206,126,10585,48607,192,100,121452,556808,14,26,83582,1584238,2604,7414,138212,195,0,26,0,0,100,0
Bacteroides_ovatus_58035,700014562,700122765,570,926763,131859,604274,197,122,9320,42961,173,93,122539,561313,24,29,84179,1597177,2583,6595,122105,183,0,29,0,0,93,0
Bacteroides_ovatus_58035,700014562,700123135,560,928531,132089,605432,188,127,10734,49217,180,99,121355,556215,8,28,83489,1582567,2589,7483,139970,198,0,28,0,0,99,0
Bacteroides_ovatus_58035,700014562,700161945,583,926826,131715,604329,204,128,11571,52957,197,107,120144,551372,7,21,82844,1568689,2583,8047,150611,213,0,21,0,0,107,0
Bacteroides_ovatus_58035,700014562,700164641,550,912588,129824,594998,186,120,9626,44287,174,93,120198,550711,12,27,82741,1566845,2547,6768,125907,186,0,27,0,0,93,0
Bacteroides_ovatus_58035,700014562,700171441,618,920178,130519,599931,220,131,11855,54274,202,107,118664,545657,18,24,82158,1552233,2580,8229,154383,210,0,24,0,0,107,0
Bacteroides_ovatus_58035,700014562,ERR911967,650,934948,132931,609620,233,124,11640,53415,223,103,121291,556205,10,21,83547,1582455,2613,8121,151905,219,0,21,0,0,103,0
Bacteroides_ovatus_58035,700014562,ERR912031,740,925694,131618,603583,278,154,14510,65429,261,125,117108,538154,17,29,80826,1531092,2544,9910,186119,258,0,29,0,0,125,0
Bacteroides_ovatus_58035,700014724,700023113,47,931290,132395,607193,18,20,619,2690,16,5,131776,604503,2,15,90961,1719692,2856,413,7654,3,1,14,0,0,5,0
Bacteroides_ovatus_58035,700014724,700095213,46,928905,132092,605629,18,18,609,2654,16,5,131483,602975,2,13,90719,1715368,2838,406,7553,3,1,12,0,0,5,0
Bacteroides_ovatus_58035,700014724,700102043,49,929050,132143,605744,19,20,609,2658,16,5,131534,603086,3,15,90719,1715722,2817,408,7563,3,1,14,0,0,5,0
Bacteroides_ovatus_58035,700014724,700106170,74,929473,132135,606025,25,22,908,4230,25,6,131227,601795,0,16,90546,1711998,2841,669,12015,6,1,14,1,0,6,0
Bacteroides_ovatus_58035,700014724,700114082,55,928043,131866,605066,20,23,609,2658,16,5,131257,602408,4,18,90691,1713686,2847,408,7563,3,1,17,0,0,5,0
Bacteroides_ovatus_58035,700014724,700116468,84,929443,132062,605993,30,29,1802,8057,28,11,130260,597936,2,18,90062,1700923,2823,1155,22983,33,1,17,0,0,11,0
Bacteroides_ovatus_58035,700014724,700122765,63,927836,131957,604947,25,22,1266,5704,22,6,130691,599243,3,16,90048,1704882,2799,916,16184,12,1,15,0,0,6,0
Bacteroides_ovatus_58035,700014724,700123135,53,929641,132196,606130,16,27,619,2688,16,5,131577,603442,0,22,90780,1716720,2826,409,7652,3,1,21,0,0,5,0
Bacteroides_ovatus_58035,700014724,700164641,46,915595,130210,596960,17,20,619,2690,16,5,129591,594270,1,15,89460,1690575,2775,413,7654,3,1,14,0,0,5,0
Bacteroides_ovatus_58035,700014724,700171441,60,921903,130746,601053,22,17,393,1861,10,2,130353,599192,12,15,90390,1704357,2829,236,5341,6,1,14,0,0,2,0
Bacteroides_ovatus_58035,700014724,ERR911967,143,931403,132417,607283,61,24,1529,6869,59,8,130888,600414,2,16,90328,1708076,2838,1052,19534,21,1,15,0,0,8,0
Bacteroides_ovatus_58035,700014724,ERR912031,301,922083,131092,601208,128,73,5922,25935,110,45,125170,575273,18,28,86540,1636543,2736,3887,73825,93,1,27,0,0,45,0
Bacteroides_ovatus_58035,700014724,ERR912193,562,928245,131921,605204,193,130,10291,47376,180,95,121630,557828,13,35,83830,1586999,2655,7249,134681,198,1,34,0,0,95,0
Bacteroides_ovatus_58035,700016000,700023113,57,932749,132673,608191,21,27,380,1742,15,3,132293,606449,6,24,91190,1725313,2844,273,4950,3,0,24,0,0,3,0
Bacteroides_ovatus_58035,700016000,700095213,56,929315,132187,605917,21,25,619,2692,16,5,131568,603225,5,20,90715,1716128,2832,413,7660,3,0,20,0,0,5,0
Bacteroides_ovatus_58035,700016000,700102043,59,929674,132284,606151,22,27,609,2648,16,5,131675,603503,6,22,90746,1716961,2802,404,7537,3,0,22,0,0,5,0
Bacteroides_ovatus_58035,700016000,700106170,84,930400,132339,606647,28,29,898,4191,25,6,131441,602456,3,23,90610,1713926,2832,661,11906,6,0,22,1,0,6,0
Bacteroides_ovatus_58035,700016000,700114082,65,927954,131906,605003,23,30,609,2654,16,5,131297,602349,7,25,90645,1713570,2832,406,7553,3,0,25,0,0,5,0
Bacteroides_ovatus_58035,700016000,700116468,94,930191,132215,606512,33,36,1802,8059,28,11,130413,598453,5,25,90088,1702466,2805,1155,22989,33,0,25,0,0,11,0
Bacteroides_ovatus_58035,700016000,700122765,73,929520,132255,606077,28,29,619,2692,16,5,131636,603385,12,24,90688,1716656,2811,413,7660,3,0,24,0,0,5,0
Bacteroides_ovatus_58035,700016000,700123135,63,931496,132540,607365,19,34,609,2646,16,5,131931,604719,3,29,90916,1720415,2826,403,7532,3,0,29,0,0,5,0
Bacteroides_ovatus_58035,700016000,700164641,56,915483,130248,596891,20,27,619,2690,16,5,129629,594201,4,22,89422,1690409,2772,410,7657,3,0,22,0,0,5,0
Bacteroides_ovatus_58035,700016000,700171441,70,922694,130904,601588,25,24,391,1854,10,2,130513,599734,15,22,90432,1705944,2826,235,5321,6,0,22,0,0,2,0
Bacteroides_ovatus_58035,700016000,ERR911967,153,933061,132730,608411,64,31,1510,6786,59,8,131220,601625,5,23,90452,1711597,2826,1037,19300,21,0,23,0,0,8,0
Bacteroides_ovatus_58035,700016000,ERR912031,319,923747,131399,602342,135,82,5663,24846,108,42,125736,577496,27,40,86820,1642944,2724,3721,70724,93,0,40,0,0,42,0
Bacteroides_ovatus_58035,700016000,ERR912193,572,929713,132193,606204,196,137,10256,47206,180,96,121937,558998,16,41,83954,1590403,2637,7214,134203,201,0,41,0,0,96,0
Bacteroides_ovatus_58035,700016542,700023919,606,875240,124323,570622,212,143,10097,45878,211,117,114226,524744,1,26,78979,1492799,2454,7015,130454,165,0,26,0,0,117,0
Bacteroides_ovatus_58035,700016542,700024086,2598,836640,118798,545449,1063,425,31463,144570,1059,364,87335,400879,4,61,60687,1140021,1929,21461,411652,597,0,61,0,3,361,0
Bacteroides_ovatus_58035,700016542,700096865,59,873799,124265,569653,28,15,1482,6243,27,8,122783,563410,1,7,84940,1602692,2598,846,17865,18,0,7,0,0,8,0
Bacteroides_ovatus_58035,700016542,700106170,1806,879882,124997,573625,677,345,26280,120793,635,253,98717,452832,42,92,68218,1288160,2118,18208,343637,534,1,89,2,0,253,0
Bacteroides_ovatus_58035,700016542,700117239,1824,880034,125016,573731,692,350,27379,125608,654,262,97637,448123,38,88,67481,1274791,2097,18948,357318,558,1,86,1,0,262,0
Bacteroides_ovatus_58035,700016542,700123135,1799,879808,125021,573573,674,350,26432,121326,637,256,98589,452247,37,94,68111,1286536,2094,18275,345154,549,1,92,1,0,256,0
Bacteroides_ovatus_58035,700016542,700161342,185,876447,124540,571419,54,34,3190,14790,54,30,121350,556629,0,4,83815,1583510,2562,2222,42082,66,0,4,0,0,30,0
Bacteroides_ovatus_58035,700016542,700171648,463,869227,123230,566673,160,109,8158,37595,157,90,115072,529078,3,19,79750,1505024,2460,5786,106849,150,0,19,0,0,90,0
Bacteroides_ovatus_58035,700016542,700172813,470,873848,124163,569705,163,108,8264,37998,161,93,115899,531707,2,15,79970,1512688,2463,5852,107986,156,0,15,0,0,93,0
Bacteroides_ovatus_58035,700016542,ERR912031,1756,871768,123866,568331,650,334,23206,107699,603,236,100660,460632,47,98,69169,1310618,2109,16413,306162,522,1,96,1,0,236,0
Bacteroides_ovatus_58035,700023113,700106170,41,932210,132545,607812,11,12,279,1481,9,1,132266,606331,2,11,91244,1724893,2856,245,4195,3,0,10,1,0,1,0
Bacteroides_ovatus_58035,700023113,700116468,51,932599,132500,608055,16,19,1183,5367,12,6,131317,602688,4,13,90777,1714446,2841,742,15329,30,0,13,0,0,6,0
Bacteroides_ovatus_58035,700023113,700117239,42,933202,132659,608481,20,14,619,2692,16,5,132040,605789,4,9,91120,1723394,2853,413,7660,3,0,9,0,0,5,0
Bacteroides_ovatus_58035,700023113,700122765,30,930265,132319,606553,11,12,647,2992,6,1,131672,603561,5,11,90682,1717193,2808,502,8465,9,0,11,0,0,1,0
Bacteroides_ovatus_58035,700023113,700161945,43,931141,132292,607139,18,16,609,2658,16,5,131683,604481,2,11,90971,1719631,2841,408,7563,3,0,11,0,0,5,0
Bacteroides_ovatus_58035,700023113,700171441,85,924576,131104,602789,40,19,1232,5599,26,7,129872,597190,14,12,90088,1698647,2835,797,15988,12,0,12,0,0,7,0
Bacteroides_ovatus_58035,700023113,700171648,1856,887703,125827,578694,706,352,28658,131938,678,292,97169,446756,28,60,67345,1270829,2094,19989,375216,609,1,58,1,0,292,0
Bacteroides_ovatus_58035,700023113,ERR911967,110,940721,133730,613385,47,14,910,4178,43,3,132820,609207,4,11,91661,1733086,2874,638,11878,18,0,11,0,0,3,0
Bacteroides_ovatus_58035,700023113,ERR912031,292,931064,132346,607090,124,68,5606,24638,108,44,126740,582452,16,24,87635,1656952,2769,3688,70136,90,0,24,0,0,44,0
Bacteroides_ovatus_58035,700023113,ERR912193,529,934104,132753,609033,179,120,9382,43338,163,90,123371,565695,16,30,85018,1609388,2679,6640,123185,189,0,30,0,0,90,0
Bacteroides_ovatus_58035,700023267,700107930,509,839338,119108,547219,201,89,7928,36389,181,51,111180,510830,20,38,77111,1453087,2292,5419,103583,165,1,37,0,1,50,0
Bacteroides_ovatus_58035,700023267,700111223,701,842404,119626,549142,255,162,10013,45972,244,121,109613,503170,11,41,75998,1431283,2229,6850,130859,207,2,38,1,1,120,0
Bacteroides_ovatus_58035,700023267,700161856,679,843763,119502,550024,294,117,9970,46191,288,83,109532,503833,6,34,76379,1432771,2349,6828,131580,165,1,33,0,1,82,0
Bacteroides_ovatus_58035,700023267,ERR912068,688,848646,120349,553243,276,127,8578,39327,267,93,111771,513916,9,34,77618,1461754,2376,5945,111886,150,1,33,0,1,92,0
Bacteroides_ovatus_58035,700023267,ERR912139,1296,855907,121378,557973,550,220,18779,85283,541,185,102599,472690,9,35,71730,1344204,2136,12508,242954,387,1,34,0,2,183,0
Bacteroides_ovatus_58035,700023337,700033797,639,835303,118666,544434,242,136,9916,46317,232,109,108750,498117,10,27,74833,1417364,2154,7239,131502,210,0,27,0,1,107,1
Bacteroides_ovatus_58035,700023337,700121919,199,841970,119601,548791,73,41,1957,8836,68,27,117644,539955,5,14,81343,1536050,2472,1312,25172,24,0,14,0,0,27,0
Bacteroides_ovatus_58035,700023337,ERR911997,301,851126,120897,554784,124,47,3248,14718,123,37,117649,540066,1,10,81402,1536327,2469,2218,41891,45,0,10,0,0,37,0
Bacteroides_ovatus_58035,700023337,ERR912004,869,850139,120773,554150,344,154,13445,63042,327,129,107328,491108,17,25,73789,1397315,2220,9773,179080,273,0,25,0,1,128,0
Bacteroides_ovatus_58035,700023337,ERR912033,626,836563,118737,545211,235,131,10386,48505,228,110,108351,496706,7,21,74731,1413131,2256,7577,137707,231,0,21,0,1,109,0
Bacteroides_ovatus_58035,700023337,ERR912114,92,851347,120944,554936,36,21,673,3100,33,9,120271,551836,3,12,83195,1569814,2499,463,8834,3,0,12,0,0,9,0
Bacteroides_ovatus_58035,700023337,ERR912181,332,839882,119252,547417,131,76,4673,21489,129,62,114579,525928,2,14,79418,1495963,2403,3161,61228,78,0,14,0,0,62,0
Bacteroides_ovatus_58035,700023337,SRR341651,705,842812,119544,549424,285,122,10973,51127,274,99,108571,498297,11,23,74985,1417668,2238,7985,145156,240,0,23,0,1,98,0
Bacteroides_ovatus_58035,700023337,SRR413629,81,840942,119414,548129,24,21,403,1696,20,3,119011,546433,4,18,82425,1554372,2502,224,4864,0,0,18,0,0,3,0
Bacteroides_ovatus_58035,700023919,700024086,3071,851645,120949,555236,1256,512,35219,161583,1248,443,85730,393653,8,69,59482,1119539,1938,24136,459956,657,0,69,0,3,440,0
Bacteroides_ovatus_58035,700023919,700096865,634,876139,124592,571209,223,157,8894,39972,218,114,115698,531237,5,43,79975,1511270,2466,6026,113737,153,0,43,0,0,114,0
Bacteroides_ovatus_58035,700023919,700161342,461,889729,126466,580067,168,116,7116,31865,166,94,119350,548202,2,22,82427,1559623,2556,4901,90583,111,0,22,0,0,94,0
Bacteroides_ovatus_58035,700023919,700171648,260,884372,125388,576527,102,67,4169,18664,100,45,121219,557863,2,22,84204,1586775,2610,2807,53104,81,0,22,0,0,45,0
Bacteroides_ovatus_58035,700023919,700172813,214,887551,126147,578623,81,61,3715,16545,80,41,122432,562078,1,20,84639,1598985,2610,2501,47068,66,0,20,0,0,41,0
Bacteroides_ovatus_58035,700024086,700096865,2644,837376,119096,545945,1087,437,31337,143922,1081,367,87759,402023,6,70,60864,1143264,1941,21273,409923,570,0,70,0,3,364,0
Bacteroides_ovatus_58035,700024086,700161342,2838,854631,121417,557197,1163,452,32185,148211,1158,388,89232,408986,5,64,61853,1163143,1962,21924,422097,612,0,64,0,3,385,0
Bacteroides_ovatus_58035,700024086,700171648,2903,843766,119526,550071,1174,479,33353,154338,1168,414,86173,395733,6,65,59858,1125424,1917,23144,439213,657,0,65,0,3,411,0
Bacteroides_ovatus_58035,700024086,700172813,2898,846579,120300,551909,1183,469,33955,156275,1178,408,86345,395634,5,61,59757,1125234,1911,23305,444869,651,0,61,0,3,405,0
Bacteroides_ovatus_58035,700024233,700038702,726,813884,115564,530607,273,171,17572,81261,255,130,97992,449346,18,41,67499,1278427,2112,12433,231020,330,1,40,0,2,128,0
Bacteroides_ovatus_58035,700024233,ERR911970,530,834220,118376,543785,194,133,10020,46085,181,85,108356,497700,13,48,75020,1415773,2307,6964,131114,177,1,47,0,0,85,0
Bacteroides_ovatus_58035,700024449,700117766,753,832493,118230,542684,291,158,13028,58325,281,110,105202,484359,10,48,73072,1377734,2271,8613,166140,222,0,48,0,0,110,0
Bacteroides_ovatus_58035,700024449,ERR911986,896,836253,118654,545197,365,173,13509,60632,355,148,105145,484565,10,25,73308,1378137,2250,8829,172836,231,0,25,0,0,148,0
Bacteroides_ovatus_58035,700024673,700033797,1625,837978,119066,546157,601,316,27466,124908,583,262,91600,421249,18,54,63824,1198057,1866,18515,355705,504,0,54,0,1,260,1
Bacteroides_ovatus_58035,700024673,700035747,1301,841474,119516,548433,479,257,23107,103610,454,195,96409,444823,25,62,67461,1264932,2076,15305,295117,408,0,62,0,1,194,0
Bacteroides_ovatus_58035,700024673,700038167,1018,850929,120833,554658,382,191,18242,82585,375,155,102591,472073,7,36,71393,1342645,2181,12254,235177,324,0,36,0,1,154,0
Bacteroides_ovatus_58035,700024673,700106325,304,849226,120606,553521,122,59,5302,24580,108,41,115304,528941,14,18,79506,1504911,2406,3965,69655,120,0,18,0,0,41,0
Bacteroides_ovatus_58035,700024673,700122860,1388,852030,121118,555427,551,250,23418,107070,542,211,97700,448357,9,39,67242,1275807,2022,16368,304401,441,0,39,0,1,210,0
Bacteroides_ovatus_58035,700024673,700123959,1519,853990,121391,556623,575,286,28355,127955,569,233,93036,428668,6,53,65203,1218824,1977,18700,364649,516,0,53,0,1,232,0
Bacteroides_ovatus_58035,700024673,ERR912033,1670,849477,120599,553665,625,321,31549,142800,609,271,89050,410865,16,50,62350,1168310,1935,21204,406599,597,1,49,0,0,271,0
Bacteroides_ovatus_58035,700024673,ERR912038,1485,851819,121050,555204,576,274,27982,126092,570,231,93068,429112,6,43,65257,1220117,1962,18431,359317,528,0,43,0,1,230,0
Bacteroides_ovatus_58035,700024673,ERR912052,1531,850886,120926,554617,591,290,28677,129141,582,237,92249,425476,9,53,64753,1209707,1968,18854,368041,528,0,53,0,1,236,0
Bacteroides_ovatus_58035,700024673,ERR912187,1536,852201,121124,555501,609,272,27649,124569,595,225,93475,430932,14,47,65490,1225320,1986,18256,354929,522,0,47,0,0,225,0
Bacteroides_ovatus_58035,700024673,SRR341651,1731,856755,121584,558547,670,298,30239,137543,657,256,91345,421004,13,42,63921,1197087,2004,20346,391758,525,1,41,0,0,256,0
Bacteroides_ovatus_58035,700024789,ERR912163,57,854160,121276,556818,20,16,969,3953,15,6,120307,552865,5,10,83390,1572718,2487,514,11330,15,0,10,0,0,6,0
Bacteroides_ovatus_58035,700024930,700038594,155,835972,118664,544848,52,46,677,3161,40,16,117987,541687,12,30,81739,1540838,2484,457,8999,27,1,29,0,0,16,0
Bacteroides_ovatus_58035,700024930,700116401,138,835352,118553,544430,43,44,528,2389,28,14,118025,542041,15,30,81812,1541815,2496,339,6810,18,1,29,0,0,14,0
Bacteroides_ovatus_58035,700024930,700172132,419,839387,119198,547108,157,106,5459,25120,135,49,113739,521988,22,57,78552,1485033,2379,3859,71381,120,1,56,0,1,48,0
Bacteroides_ovatus_58035,700024930,SRR413659,662,820563,116580,534810,254,149,14848,67707,233,98,101732,467103,21,51,70763,1328443,2103,9810,192945,366,0,51,0,1,97,0
Bacteroides_ovatus_58035,700033797,700034166,636,836773,118856,545429,243,132,9974,46642,232,110,108882,498787,11,22,74979,1419240,2142,7302,132411,213,0,22,0,1,108,1
Bacteroides_ovatus_58035,700033797,700038167,1578,837136,118827,545714,624,269,25876,116717,610,231,92951,428997,14,38,65270,1219810,1911,17059,332636,456,0,38,0,2,228,1
Bacteroides_ovatus_58035,700033797,700121919,811,838062,119056,546280,307,167,11893,55267,297,140,107163,491013,10,27,73673,1397227,2139,8605,156962,234,0,27,0,1,138,1
Bacteroides_ovatus_58035,700033797,700173546,663,844722,120004,550613,257,133,10221,47744,247,112,109783,502869,10,21,75529,1430906,2172,7487,135529,216,0,21,0,1,110,1
Bacteroides_ovatus_58035,700033797,ERR911997,994,846832,120301,552020,401,171,14301,66234,395,150,106000,485786,6,21,72926,1382308,2124,10253,188179,270,0,21,0,1,148,1
Bacteroides_ovatus_58035,700033797,ERR912004,308,848172,120474,552889,131,47,4066,19245,123,32,116408,533644,8,15,80446,1518176,2310,2916,54738,81,0,15,0,0,31,1
Bacteroides_ovatus_58035,700033797,ERR912033,125,837603,118911,545930,53,29,1284,5883,49,18,117627,540047,4,11,81541,1536251,2349,825,16785,39,0,11,0,0,17,1
Bacteroides_ovatus_58035,700033797,ERR912064,670,838321,119032,546423,258,133,10091,47160,246,110,108941,499263,12,23,75066,1420551,2172,7367,133900,213,0,23,0,1,108,1
Bacteroides_ovatus_58035,700033797,ERR912113,675,837513,118970,545879,258,134,10128,47338,248,111,108842,498541,10,23,74879,1418578,2166,7420,134384,210,1,22,0,1,109,1
Bacteroides_ovatus_58035,700033797,ERR912114,762,847182,120374,552235,297,146,11486,53547,289,121,108888,498688,8,25,74866,1419029,2169,8362,152054,225,0,25,0,1,119,1
Bacteroides_ovatus_58035,700033797,ERR912181,983,836565,118820,545268,384,203,14690,68541,375,174,104130,476727,9,29,71696,1356421,2064,10542,194778,303,0,29,0,1,172,1
Bacteroides_ovatus_58035,700033797,SRR341651,210,841092,119326,548324,94,33,1998,9094,91,22,117328,539230,3,11,81455,1533901,2334,1295,25939,48,0,11,0,0,21,1
Bacteroides_ovatus_58035,700033797,SRR413629,703,837369,118949,545831,266,143,10629,49336,254,113,108320,496495,12,30,74609,1412713,2163,7671,140115,222,0,30,0,1,111,1
Bacteroides_ovatus_58035,700033922,700172621,1885,864165,122907,563439,760,306,29711,136345,748,283,93196,427094,12,23,64258,1214999,2025,20462,388021,552,1,22,0,0,283,0
Bacteroides_ovatus_58035,700034166,700121919,191,845486,120116,551134,76,35,2015,9094,72,27,118101,542040,4,8,81688,1541972,2460,1350,25908,24,0,8,0,0,27,0
Bacteroides_ovatus_58035,700034166,ERR911997,292,854850,121476,557241,124,42,3261,14780,122,37,118215,542461,2,5,81763,1543172,2448,2238,42057,45,0,5,0,0,37,0
Bacteroides_ovatus_58035,700034166,ERR912004,863,853962,121372,556668,343,149,13041,60597,323,130,108331,496071,20,19,74541,1411443,2229,9412,172136,243,0,19,0,1,129,0
Bacteroides_ovatus_58035,700034166,ERR912033,634,840653,119370,547930,243,129,11488,53612,235,111,107882,494318,8,18,74349,1406361,2244,8344,152264,228,0,18,0,1,110,0
Bacteroides_ovatus_58035,700034166,ERR912114,83,855113,121539,557399,34,18,662,3053,29,9,120877,554346,5,9,83581,1576970,2487,454,8702,3,0,9,0,0,9,0
Bacteroides_ovatus_58035,700034166,ERR912181,330,843926,119896,550070,134,73,4742,21685,132,61,115154,528385,2,12,79807,1502954,2394,3174,61803,78,0,12,0,0,61,0
Bacteroides_ovatus_58035,700034166,SRR341651,703,846105,120068,551588,287,120,11632,54088,278,102,108436,497500,9,18,74847,1415433,2220,8466,153561,237,0,18,0,1,101,0
Bacteroides_ovatus_58035,700034166,SRR413629,74,845068,120066,550847,25,16,413,1740,20,3,119653,549107,5,13,82831,1562003,2487,226,4994,0,0,13,0,0,3,0
Bacteroides_ovatus_58035,700034794,700108840,97,836703,118839,545440,37,21,1610,7573,22,5,117229,537867,15,16,81098,1530145,2358,1116,21558,45,0,16,0,0,5,0
Bacteroides_ovatus_58035,700034794,ERR912183,600,831717,118029,542242,232,123,11264,51334,222,85,106765,490908,10,38,74312,1396222,2190,7547,146233,222,0,38,0,0,85,0
Bacteroides_ovatus_58035,700034794,SRR413577,602,838920,119094,546899,264,93,10490,47862,250,73,108604,499037,14,20,75320,1419607,2184,7182,136158,246,0,20,0,0,73,0
Bacteroides_ovatus_58035,700034794,SRR413641,525,844175,119849,550329,232,81,10024,45473,228,66,109825,504856,4,15,76204,1436162,2202,6814,129374,231,0,15,0,0,66,0
Bacteroides_ovatus_58035,700035747,700038167,472,847878,120337,552645,182,102,9716,43132,165,66,110621,509513,17,36,77030,1449148,2361,6410,122821,165,0,36,0,0,66,0
Bacteroides_ovatus_58035,700035747,700122860,804,846064,120158,551447,334,150,14046,63586,322,109,106112,487861,12,41,73356,1388004,2223,9821,180685,252,0,41,0,0,109,0
Bacteroides_ovatus_58035,700035747,700123959,1021,848690,120528,553146,397,205,20361,91291,376,137,100167,461855,21,68,70033,1313381,2151,13473,260031,369,0,68,0,0,137,0
Bacteroides_ovatus_58035,700035747,ERR912038,966,843381,119751,549670,389,191,19331,86468,372,133,100420,463202,17,58,70307,1317139,2160,12667,246386,351,0,58,0,0,133,0
Bacteroides_ovatus_58035,700035747,ERR912052,1003,841470,119500,548391,402,206,20737,92904,387,140,98763,455487,15,66,69116,1295209,2136,13707,264636,369,0,66,0,0,140,0
Bacteroides_ovatus_58035,700035747,ERR912187,997,841648,119504,548538,408,190,19600,87656,382,130,99904,460882,26,60,69974,1310518,2154,12854,249757,357,1,59,0,0,130,0
Bacteroides_ovatus_58035,700035785,700037042,1425,831786,118107,542161,527,349,25765,116787,496,235,92342,425374,31,114,64678,1209503,1941,17225,332629,507,2,112,0,1,234,0
Bacteroides_ovatus_58035,700035785,700095410,1403,827301,117545,539264,533,314,24627,112790,505,232,92918,426474,28,82,64374,1213131,1917,16969,320912,489,2,80,0,0,232,0
Bacteroides_ovatus_58035,700035785,700106065,1362,830424,117886,541253,517,311,26658,120698,497,234,91228,420555,20,77,63981,1195746,1938,17784,343794,516,1,76,0,0,234,0
Bacteroides_ovatus_58035,700035785,700106754,1424,830865,117922,541535,542,317,25280,115817,517,241,92642,425718,25,76,64362,1210848,1944,17452,329492,507,1,75,0,0,241,0
Bacteroides_ovatus_58035,700035785,700114218,1410,831500,118058,541990,541,318,25271,115820,515,237,92787,426170,26,81,64378,1212191,1941,17457,329496,507,1,80,0,0,237,0
Bacteroides_ovatus_58035,700035785,700163030,1161,833646,118241,543325,445,250,19376,88289,416,184,98865,455036,29,66,68883,1294137,2088,13333,251165,369,1,65,0,0,184,0
Bacteroides_ovatus_58035,700035785,700163419,1399,829663,117803,540809,534,316,25480,116712,510,238,92323,424097,24,78,64022,1206331,1938,17537,332086,513,2,76,0,1,237,0
Bacteroides_ovatus_58035,700035785,700164792,1402,831548,118067,542051,538,312,24799,113852,511,231,93268,428199,27,81,64693,1217951,1953,17161,323900,495,1,80,0,0,231,0
Bacteroides_ovatus_58035,700037042,700095410,335,842550,119741,549288,114,96,6973,31003,106,35,112768,518285,8,61,78424,1474103,2328,4343,88510,156,3,58,0,0,35,0
Bacteroides_ovatus_58035,700037042,700106056,320,840252,119210,547730,114,95,6806,30285,101,35,112404,517445,13,60,78440,1471525,2370,4267,86432,156,3,57,0,0,35,0
Bacteroides_ovatus_58035,700037042,700106754,343,847528,120321,552453,116,98,6933,30846,106,36,113388,521607,10,62,79017,1483407,2397,4327,88052,159,2,60,0,0,36,0
Bacteroides_ovatus_58035,700037042,700114218,343,848615,120512,553215,120,102,6972,31014,109,37,113540,522201,11,65,79082,1485133,2388,4352,88531,159,2,63,0,0,37,0
Bacteroides_ovatus_58035,700037042,700122108,1467,838046,119065,546308,542,351,25447,115735,517,238,93618,430573,25,113,65267,1224499,1953,17096,329596,513,2,111,0,1,237,0
Bacteroides_ovatus_58035,700037042,700163030,588,847535,120236,552458,220,167,10151,45525,204,94,110085,506933,16,73,76973,1441471,2355,6486,129897,192,2,71,0,0,94,0
Bacteroides_ovatus_58035,700037042,700163419,333,846577,120268,551902,115,99,6903,30659,104,36,113365,521243,11,63,78845,1482499,2385,4279,87542,156,4,59,0,0,36,0
Bacteroides_ovatus_58035,700037042,700164792,326,846963,120282,552153,116,96,7003,31143,106,39,113279,521010,10,57,78919,1481735,2376,4374,88896,159,2,55,0,0,39,0
Bacteroides_ovatus_58035,700037090,700102242,1012,805363,114044,524923,382,258,14684,66983,335,151,99360,457940,47,107,69318,1302429,2073,9932,190735,282,2,105,0,0,151,0
Bacteroides_ovatus_58035,700037090,ERR912179,1099,815568,115456,531627,397,274,15144,69507,347,170,100312,462120,50,104,69736,1314473,2151,10518,197706,297,1,103,0,0,170,0
Bacteroides_ovatus_58035,700038167,700106325,1162,847121,120199,552226,446,211,22379,102201,433,168,97820,450025,13,43,67902,1280076,2097,15409,290771,423,0,43,0,1,167,0
Bacteroides_ovatus_58035,700038167,700122860,526,856718,121600,558504,221,104,8745,40583,217,79,112855,517921,4,25,77692,1473761,2310,6497,115066,186,0,25,0,0,79,0
Bacteroides_ovatus_58035,700038167,700123959,705,859873,121986,560534,257,138,13913,63160,251,92,108073,497374,6,46,75339,1414485,2298,9242,179989,249,0,46,0,0,92,0
Bacteroides_ovatus_58035,700038167,ERR912004,1951,862660,122351,562425,793,301,29951,136169,774,253,92400,426256,19,48,65003,1211731,2034,19876,388121,510,0,48,0,2,251,0
Bacteroides_ovatus_58035,700038167,ERR912033,1620,846658,120023,551877,635,276,25549,115602,616,235,94474,436275,19,41,66444,1240302,2079,16934,329428,444,0,41,0,2,233,0
Bacteroides_ovatus_58035,700038167,ERR912038,654,855457,121383,557645,247,126,12301,55736,242,85,109082,501909,5,41,76073,1427347,2307,8081,158902,225,0,41,0,0,85,0
Bacteroides_ovatus_58035,700038167,ERR912052,694,853020,121071,556017,258,141,13614,61743,253,91,107457,494274,5,50,74889,1405650,2283,9039,175947,243,0,50,0,0,91,0
Bacteroides_ovatus_58035,700038167,ERR912187,690,853623,121149,556423,266,125,12489,56473,247,82,108660,499950,19,43,75794,1421746,2310,8197,160985,237,1,42,0,0,82,0
Bacteroides_ovatus_58035,700038167,SRR341651,1727,854242,120949,556980,704,265,27729,125488,694,230,93220,431492,10,35,65914,1226510,2052,18277,357710,477,0,35,0,2,228,0
Bacteroides_ovatus_58035,700038594,700172132,304,835962,118728,544910,107,82,5323,24717,92,39,113405,520193,15,43,78271,1479947,2361,3836,70204,111,1,42,0,0,39,0
Bacteroides_ovatus_58035,700038594,SRR413659,667,815821,115890,531742,244,149,13815,63079,230,106,102075,468663,14,43,71066,1332811,2112,9093,179817,327,0,43,0,0,106,0
Bacteroides_ovatus_58035,700038702,ERR911970,508,809210,114804,527594,174,136,9478,43729,156,80,105326,483865,18,56,72731,1376626,2238,6795,124197,195,0,56,0,2,78,0
Bacteroides_ovatus_58035,700095213,700106170,40,928745,132069,605543,11,10,289,1535,9,1,131780,604008,2,9,90860,1718326,2838,255,4347,3,0,8,1,0,1,0
Bacteroides_ovatus_58035,700095213,700116468,50,928560,131983,605413,16,17,1183,5367,12,6,130800,600046,4,11,90359,1706962,2817,742,15329,30,0,11,0,0,6,0
Bacteroides_ovatus_58035,700095213,700117239,41,929326,132148,605919,20,12,609,2654,16,5,131539,603265,4,7,90736,1716218,2841,406,7553,3,0,7,0,0,5,0
Bacteroides_ovatus_58035,700095213,700122765,29,927453,131937,604693,11,10,657,3048,6,1,131280,601645,5,9,90400,1711736,2799,511,8624,9,0,9,0,0,1,0
Bacteroides_ovatus_58035,700095213,700161945,44,928187,131938,605188,18,16,609,2658,16,5,131329,602530,2,11,90663,1714101,2826,408,7563,3,0,11,0,0,5,0
Bacteroides_ovatus_58035,700095213,700171441,84,921227,130687,600598,40,17,1351,6070,29,7,129336,594528,11,10,89658,1691103,2823,874,17324,12,0,10,0,0,7,0
Bacteroides_ovatus_58035,700095213,ERR911967,109,930234,132294,606515,47,12,901,4115,43,3,131393,602400,4,9,90615,1713753,2832,625,11702,18,0,9,0,0,3,0
Bacteroides_ovatus_58035,700095213,ERR912031,268,920940,130969,600459,114,62,5274,23114,94,41,125695,577345,20,21,86841,1642467,2727,3454,65795,93,0,21,0,0,41,0
Bacteroides_ovatus_58035,700095213,ERR912193,528,927341,131834,604609,179,118,9513,43919,165,90,122321,560690,14,28,84247,1595174,2649,6719,124843,195,0,28,0,0,90,0
Bacteroides_ovatus_58035,700095410,700106056,29,837794,118955,546168,11,15,59,284,5,0,118896,545884,6,15,82297,1552877,2478,48,804,0,2,13,0,0,0,0
Bacteroides_ovatus_58035,700095410,700106065,287,843616,119838,549961,110,60,7013,31215,106,35,112825,518746,4,25,78449,1475443,2346,4368,89121,156,1,24,0,0,35,0
Bacteroides_ovatus_58035,700095410,700122108,1438,837433,119087,545962,549,313,24837,113595,525,228,94250,432367,24,85,65113,1230047,1941,17025,323280,480,2,83,0,0,228,0
Bacteroides_ovatus_58035,700095410,700163030,570,845787,120016,551401,236,134,9719,44503,225,92,110297,506898,11,42,76548,1441821,2325,6607,126731,171,0,42,0,1,91,0
Bacteroides_ovatus_58035,700096865,700161342,216,877240,124835,571935,68,47,3169,14628,67,36,121666,557307,1,11,83856,1585503,2562,2160,41664,60,0,11,0,0,36,0
Bacteroides_ovatus_58035,700096865,700171648,490,869844,123436,567092,170,123,6991,31985,163,85,116445,535107,7,38,80675,1522171,2475,4852,90968,135,0,38,0,0,85,0
Bacteroides_ovatus_58035,700096865,700172813,497,875620,124561,570858,173,122,7108,32474,167,87,117453,538384,6,35,80957,1531717,2478,4940,92341,141,0,35,0,0,87,0
Bacteroides_ovatus_58035,700097234,ERR912150,1156,834002,118688,543701,448,216,19273,87728,438,182,99415,455973,10,34,68643,1297320,1956,13006,249749,429,0,34,0,1,181,0
Bacteroides_ovatus_58035,700098867,700111745,131,839452,119340,547213,48,38,1272,5877,30,22,118068,541336,18,16,81313,1540277,2418,903,16710,18,0,16,0,0,22,0
Bacteroides_ovatus_58035,700098867,700164354,129,841473,119648,548527,47,41,1471,6782,30,24,118177,541745,17,17,81373,1541432,2430,1051,19274,21,0,17,0,0,24,0
Bacteroides_ovatus_58035,700098867,700172393,132,840282,119419,547772,45,45,1310,6087,30,22,118109,541685,15,23,81415,1541213,2427,943,17297,21,1,22,0,0,22,0
Bacteroides_ovatus_58035,700098867,ERR912127,154,853521,121377,556415,52,43,1160,5221,30,13,120217,551194,22,30,82793,1568335,2454,782,14863,18,0,30,0,0,13,0
Bacteroides_ovatus_58035,700098867,SRR413556,25,851865,121110,555362,8,11,78,428,3,1,121032,554934,5,10,83370,1578957,2475,67,1217,0,0,10,0,0,1,0
Bacteroides_ovatus_58035,700102043,700106170,43,928926,132126,605651,12,12,279,1481,9,1,131847,604170,3,11,90887,1718815,2808,245,4195,3,0,10,1,0,1,0
Bacteroides_ovatus_58035,700102043,700116468,53,928924,132059,605652,17,19,1183,5367,12,6,130876,600285,5,13,90388,1707674,2793,742,15329,30,0,13,0,0,6,0
Bacteroides_ovatus_58035,700102043,700117239,44,929617,132223,606118,21,14,619,2690,16,5,131604,603428,5,9,90754,1716722,2808,413,7654,3,0,9,0,0,5,0
Bacteroides_ovatus_58035,700102043,700122765,32,927795,132017,604923,12,12,647,2992,6,1,131370,601931,6,11,90441,1712580,2772,502,8465,9,0,11,0,0,1,0
Bacteroides_ovatus_58035,700102043,700161945,45,928277,131962,605241,19,16,619,2692,16,5,131343,602549,3,11,90668,1714171,2808,413,7660,3,0,11,0,0,5,0
Bacteroides_ovatus_58035,700102043,700171441,87,921363,130735,600681,41,19,1243,5614,26,8,129492,595067,15,11,89747,1692661,2793,796,16034,12,0,11,0,0,8,0
Bacteroides_ovatus_58035,700102043,ERR911967,112,930977,132455,607006,48,14,901,4125,43,3,131554,602881,5,11,90670,1715165,2808,628,11729,18,0,11,0,0,3,0
Bacteroides_ovatus_58035,700102043,ERR912031,270,921373,131077,600746,114,63,5218,22816,88,38,125859,577930,26,25,86916,1644171,2703,3409,64949,90,0,25,0,0,38,0
Bacteroides_ovatus_58035,700102043,ERR912193,530,927646,131912,604814,179,120,9526,43954,164,92,122386,560860,15,28,84262,1595696,2622,6729,124938,195,0,28,0,0,92,0
Bacteroides_ovatus_58035,700102242,ERR912061,813,813452,115219,530207,313,179,14469,65245,272,119,100750,464962,41,60,70386,1322376,2124,9663,185793,279,1,59,0,0,119,0
Bacteroides_ovatus_58035,700102242,ERR912081,724,820239,116115,534600,284,188,12719,58338,263,123,103396,476262,21,65,71812,1354805,2169,8920,165836,258,0,65,0,0,123,0
Bacteroides_ovatus_58035,700102242,ERR912179,662,822220,116385,535936,229,180,10128,47198,210,121,106257,488738,19,59,73635,1390356,2223,7301,134083,210,1,58,0,0,121,0
Bacteroides_ovatus_58035,700102242,pluto3-11-0-0_,751,821941,116226,535728,302,175,9607,44235,265,117,106619,491493,37,58,73890,1398363,2226,7024,125483,198,1,57,0,0,117,0
Bacteroides_ovatus_58035,700106056,700106065,268,841311,119362,548384,108,59,6826,30391,101,35,112536,517993,7,24,78506,1473082,2391,4278,86739,156,1,23,0,0,35,0
Bacteroides_ovatus_58035,700106056,700106754,39,841630,119366,548615,14,14,146,757,10,0,119220,547858,4,14,82724,1558315,2535,118,2153,0,1,13,0,0,0,0
Bacteroides_ovatus_58035,700106056,700114218,40,842083,119439,548935,15,19,148,751,10,1,119291,548184,5,18,82752,1559268,2532,117,2136,0,1,17,0,0,1,0
Bacteroides_ovatus_58035,700106056,700122108,1409,831581,118029,542081,542,314,25350,116379,519,238,92679,425702,23,76,64237,1210934,1935,17508,331122,507,2,74,0,0,238,0
Bacteroides_ovatus_58035,700106056,700163030,540,840776,119185,548047,223,133,9448,43319,202,88,109737,504728,21,45,76403,1435423,2358,6424,123359,174,1,44,0,0,88,0
Bacteroides_ovatus_58035,700106056,700163419,34,840920,119324,548168,12,17,129,670,5,1,119195,547498,7,16,82530,1557441,2523,105,1905,0,3,13,0,0,1,0
Bacteroides_ovatus_58035,700106056,700164792,28,841952,119434,548858,10,13,57,309,5,1,119377,548549,5,12,82805,1560316,2526,54,873,0,1,11,0,0,1,0
Bacteroides_ovatus_58035,700106065,700106754,294,845631,120003,551186,110,62,6953,30962,106,36,113050,520224,4,26,78817,1479455,2400,4344,88383,159,0,26,0,0,36,0
Bacteroides_ovatus_58035,700106065,700114218,293,846969,120211,552091,114,66,6982,31084,109,37,113229,521007,5,29,78889,1481732,2400,4367,88726,159,0,29,0,0,37,0
Bacteroides_ovatus_58035,700106065,700122108,1403,836495,118799,545261,531,313,26852,121796,512,237,91947,423465,19,76,64292,1204162,1941,17885,346981,522,1,75,0,0,237,0
Bacteroides_ovatus_58035,700106065,700163030,534,848287,120306,552924,211,130,10062,45135,198,88,110244,507789,13,42,77095,1443902,2370,6388,128825,192,0,42,0,0,88,0
Bacteroides_ovatus_58035,700106065,700163419,284,845302,120021,551021,110,63,6913,30688,104,36,113108,520333,6,27,78705,1479903,2391,4279,87629,156,2,25,0,0,36,0
Bacteroides_ovatus_58035,700106065,700164792,277,846271,120139,551676,111,60,7003,31120,106,39,113136,520556,5,21,78850,1480433,2385,4361,88840,159,0,21,0,0,39,0
Bacteroides_ovatus_58035,700106170,700114082,49,928383,131931,605276,13,15,279,1481,9,1,131652,603795,4,14,90896,1717645,2844,243,4197,3,0,13,1,0,1,0
Bacteroides_ovatus_58035,700106170,700116468,78,930077,132162,606409,23,21,1462,6840,21,7,130700,599569,2,14,90310,1705577,2820,985,19502,33,0,13,1,0,7,0
Bacteroides_ovatus_58035,700106170,700117239,69,930821,132336,606924,27,16,888,4137,25,6,131448,602787,2,10,90673,1714844,2844,651,11754,6,0,9,1,0,6,0
Bacteroides_ovatus_58035,700106170,700122765,57,928686,132103,605512,18,14,926,4474,15,2,131177,601038,3,12,90311,1710007,2796,747,12663,12,0,11,1,0,2,0
Bacteroides_ovatus_58035,700106170,700123135,47,930338,132327,606601,9,19,289,1540,9,1,132038,605061,0,18,91008,1721346,2829,256,4361,3,0,17,1,0,1,0
Bacteroides_ovatus_58035,700106170,700161945,72,929280,132050,605902,25,20,888,4125,25,6,131162,601777,0,14,90574,1711931,2826,649,11720,6,0,13,1,0,6,0
Bacteroides_ovatus_58035,700106170,700164641,40,915599,130214,596967,10,12,279,1481,9,1,129935,595486,1,11,89621,1694065,2772,245,4195,3,0,10,1,0,1,0
Bacteroides_ovatus_58035,700106170,700171441,112,922618,130844,601505,47,21,1646,7658,38,8,129198,593847,9,13,89572,1689146,2823,1147,21812,15,0,12,1,0,8,0
Bacteroides_ovatus_58035,700106170,ERR911967,137,932469,132595,607992,54,16,1180,5598,52,4,131415,602394,2,12,90637,1713707,2838,875,15898,21,0,11,1,0,4,0
Bacteroides_ovatus_58035,700106170,ERR912031,296,923145,131263,601916,121,65,5528,24447,100,39,125735,577469,21,26,86877,1642797,2733,3685,69560,96,0,26,0,0,38,1
Bacteroides_ovatus_58035,700106170,ERR912193,544,929168,132060,605821,182,120,9390,43376,168,91,122670,562445,14,29,84540,1600131,2664,6645,123297,186,0,29,0,0,90,1
Bacteroides_ovatus_58035,700106325,700122860,1480,846586,120226,551889,588,259,24177,111097,576,212,96049,440792,12,47,66196,1254149,2031,16955,315901,435,0,47,0,1,211,0
Bacteroides_ovatus_58035,700106325,ERR912038,1621,845156,119986,550913,626,294,31862,144420,613,244,88124,406493,13,50,61604,1155994,1881,21473,411166,621,0,50,0,1,243,0
Bacteroides_ovatus_58035,700106325,ERR912052,1668,843098,119702,549542,643,311,31195,141200,626,243,88507,408342,17,68,61969,1161170,1887,20921,402064,615,0,68,0,1,242,0
Bacteroides_ovatus_58035,700106325,ERR912187,1667,844016,119837,550154,656,289,32460,147462,641,245,87377,402692,15,44,61046,1145173,1857,21961,419768,657,0,44,0,0,245,0
Bacteroides_ovatus_58035,700106754,700114218,33,853089,121164,556142,6,18,77,370,1,0,121087,555772,5,18,83764,1580987,2565,54,1056,0,0,18,0,0,0,0
Bacteroides_ovatus_58035,700106754,700122108,1464,838904,119176,546871,557,321,24785,113339,533,236,94391,433532,24,85,65366,1233250,1980,17035,322496,486,1,84,0,0,236,0
Bacteroides_ovatus_58035,700106754,700163030,571,849404,120444,553702,230,135,9714,44484,219,92,110730,509218,11,43,76983,1448286,2385,6612,126663,177,0,43,0,0,92,0
Bacteroides_ovatus_58035,700107930,700111223,554,838205,119169,546496,187,118,8314,38148,174,81,110855,508348,13,37,76584,1446237,2223,5718,108546,180,1,35,1,0,81,0
Bacteroides_ovatus_58035,700107930,700161856,577,835222,118377,544518,235,79,8509,39325,219,53,109868,505193,16,26,76423,1436849,2307,5858,111967,150,0,26,0,0,53,0
Bacteroides_ovatus_58035,700107930,ERR912068,628,841159,119423,548452,241,98,8130,37434,227,60,111293,511018,14,38,76936,1453805,2313,5744,106399,159,0,38,0,0,60,0
Bacteroides_ovatus_58035,700107930,ERR912139,1292,852790,121101,556052,534,201,18765,84813,509,160,102336,471239,25,41,71332,1340336,2049,12441,241575,423,0,41,0,1,159,0
Bacteroides_ovatus_58035,700108840,700113975,112,847215,120537,552353,43,25,1522,7066,19,4,119015,545287,24,21,82099,1551374,2388,1044,20109,45,0,21,0,0,4,0
Bacteroides_ovatus_58035,700108840,700116730,103,846807,120440,552095,40,24,1600,7523,22,5,118840,544572,18,19,81986,1549363,2367,1113,21411,45,0,19,0,0,5,0
Bacteroides_ovatus_58035,700108840,ERR912183,700,840603,119483,548055,279,133,12538,57470,253,91,106945,490585,26,42,74092,1395539,2124,8496,163647,267,0,42,0,0,91,0
Bacteroides_ovatus_58035,700108840,SRR413577,741,850506,120955,554499,326,109,12456,56943,299,83,108499,497556,27,26,74979,1415544,2145,8518,162032,279,0,26,0,0,83,0
Bacteroides_ovatus_58035,700108840,SRR413641,670,856782,121881,558615,296,97,13616,61538,279,73,108265,497077,17,24,74992,1414100,2139,9091,175235,288,0,24,0,0,73,0
Bacteroides_ovatus_58035,700111223,700161856,733,838895,118986,546836,273,146,10023,45940,267,114,108963,500896,6,32,75820,1424591,2277,6828,130827,165,1,30,1,0,114,0
Bacteroides_ovatus_58035,700111223,ERR912068,695,845168,120103,550970,258,149,9307,42517,249,112,110796,508453,9,37,76629,1446450,2280,6448,120932,171,1,35,1,0,112,0
Bacteroides_ovatus_58035,700111223,ERR912139,1296,856617,121840,558456,525,230,18710,84469,511,195,103130,473987,14,35,71813,1348084,2064,12285,240741,381,1,33,1,1,194,0
Bacteroides_ovatus_58035,700111745,700172393,43,846368,120232,551709,12,19,232,1010,5,1,120000,550699,7,18,82847,1566727,2523,167,2863,0,1,17,0,0,1,0
Bacteroides_ovatus_58035,700111745,ERR912127,38,852899,121193,555985,10,17,232,1006,2,2,120961,554979,8,15,83448,1578960,2529,163,2855,0,0,15,0,0,2,0
Bacteroides_ovatus_58035,700111745,SRR413556,162,849941,120742,554074,60,40,1082,4899,31,12,119660,549175,29,28,82610,1562407,2508,722,13957,18,0,28,0,0,12,0
Bacteroides_ovatus_58035,700113975,ERR912183,628,844884,120020,550880,241,130,11258,51368,225,90,108762,499512,16,40,75491,1420807,2238,7546,146333,225,0,40,0,0,90,0
Bacteroides_ovatus_58035,700113975,SRR413577,644,854615,121478,557199,280,104,10726,48996,259,78,110752,508203,21,26,76581,1445784,2244,7339,139397,252,0,26,0,0,78,0
Bacteroides_ovatus_58035,700113975,SRR413641,568,860548,122361,561086,248,92,10361,47142,240,73,112000,513944,8,19,77409,1462167,2256,7051,134132,243,0,19,0,0,73,0
Bacteroides_ovatus_58035,700114082,700116468,59,928735,131931,605519,18,22,1183,5367,12,6,130748,600152,6,16,90423,1707207,2826,742,15329,30,0,16,0,0,6,0
Bacteroides_ovatus_58035,700114082,700117239,50,928529,131935,605388,22,17,609,2654,16,5,131326,602734,6,12,90732,1714626,2844,406,7553,3,0,12,0,0,5,0
Bacteroides_ovatus_58035,700114082,700122765,38,926459,131699,604026,13,15,657,3050,6,1,131042,600976,7,14,90363,1709766,2799,510,8631,9,0,14,0,0,1,0
Bacteroides_ovatus_58035,700114082,700161945,51,927445,131737,604694,20,19,609,2648,16,5,131128,602046,4,14,90667,1712642,2829,404,7537,3,0,14,0,0,5,0
Bacteroides_ovatus_58035,700114082,700171441,93,921296,130634,600640,42,22,1345,6057,29,7,129289,594583,13,15,89704,1691219,2826,880,17279,12,0,15,0,0,7,0
Bacteroides_ovatus_58035,700114082,ERR911967,118,929670,132118,606128,49,17,910,4172,43,3,131208,601956,6,14,90616,1712411,2841,635,11863,18,0,14,0,0,3,0
Bacteroides_ovatus_58035,700114082,ERR912031,267,920085,130743,599882,108,66,5228,22932,88,40,125515,576950,20,26,86847,1641270,2733,3432,65271,93,0,26,0,0,40,0
Bacteroides_ovatus_58035,700114082,ERR912193,537,926709,131653,604177,181,123,9520,43982,164,90,122133,560195,17,33,84227,1593694,2664,6741,125019,186,0,33,0,0,90,0
Bacteroides_ovatus_58035,700114218,700122108,1446,839773,119330,547442,554,321,24512,112325,530,229,94818,435117,24,92,65570,1237792,1989,16890,319608,477,1,91,0,0,229,0
Bacteroides_ovatus_58035,700114218,700163030,575,850343,120605,554333,235,142,9751,44683,222,95,110854,509650,13,47,77030,1449535,2385,6636,127236,177,0,47,0,0,95,0
Bacteroides_ovatus_58035,700116401,700172132,296,836274,118792,545102,102,80,4278,19839,85,29,114514,525263,17,51,79012,1494386,2391,3116,56305,96,1,50,0,0,29,0
Bacteroides_ovatus_58035,700116401,SRR413659,647,816092,115941,531924,238,146,12725,57893,220,93,103216,474031,18,53,71847,1348110,2136,8345,165025,309,0,53,0,0,93,0
Bacteroides_ovatus_58035,700116468,700117239,79,930725,132237,606856,32,23,1792,8019,28,11,130445,598837,4,12,90171,1703520,2820,1148,22876,33,0,12,0,0,11,0
Bacteroides_ovatus_58035,700116468,700122765,67,928448,131984,605352,23,21,1820,8295,19,7,130164,597057,4,14,89797,1698602,2772,1239,23607,39,0,14,0,0,7,0
Bacteroides_ovatus_58035,700116468,700123135,57,930414,132241,606647,14,26,1183,5367,12,6,131058,601280,2,20,90537,1710498,2805,742,15329,30,0,20,0,0,6,0
Bacteroides_ovatus_58035,700116468,700161945,80,929697,132048,606185,30,27,1792,8015,28,11,130256,598170,2,16,90093,1701609,2808,1146,22866,33,0,16,0,0,11,0
Bacteroides_ovatus_58035,700116468,700164641,50,915280,130113,596755,15,19,1173,5325,12,6,128940,591430,3,13,89121,1682418,2751,740,15205,30,0,13,0,0,6,0
Bacteroides_ovatus_58035,700116468,700171441,122,923120,130882,601846,52,28,2408,10905,38,14,128474,590941,14,14,89201,1680820,2802,1528,31145,42,0,14,0,0,14,0
Bacteroides_ovatus_58035,700116468,ERR911967,147,932815,132539,608210,59,23,2489,11201,55,9,130050,597009,4,14,89910,1698309,2808,1628,31912,63,0,14,0,0,9,0
Bacteroides_ovatus_58035,700116468,ERR912031,298,923223,131171,601958,120,72,6344,27992,96,43,124827,573966,24,29,86438,1632745,2715,4128,79725,123,0,29,0,0,43,0
Bacteroides_ovatus_58035,700116468,ERR912193,566,929718,132048,606175,191,129,10675,49181,177,96,121373,556994,14,33,83799,1584549,2634,7446,139872,225,0,33,0,0,96,0
Bacteroides_ovatus_58035,700116730,ERR912183,610,842624,119702,549400,235,127,13246,60608,228,93,106456,488792,7,34,73926,1390275,2175,8919,172638,267,0,34,0,0,93,0
Bacteroides_ovatus_58035,700116730,SRR413577,621,850898,120957,554753,275,96,10803,49301,259,73,110154,505452,16,23,76199,1437940,2217,7385,140275,243,0,23,0,0,73,0
Bacteroides_ovatus_58035,700116730,SRR413641,543,856720,121808,558550,240,84,10365,47066,235,67,111443,511484,5,17,77084,1455136,2232,7045,133922,231,0,17,0,0,67,0
Bacteroides_ovatus_58035,700117239,700122765,58,929812,132249,606266,27,16,1256,5644,22,6,130993,600622,5,10,90232,1708838,2796,908,16012,12,0,10,0,0,6,0
Bacteroides_ovatus_58035,700117239,700123135,48,931618,132499,607448,18,21,609,2656,16,5,131890,604792,2,16,90951,1720593,2832,407,7558,3,0,16,0,0,5,0
Bacteroides_ovatus_58035,700117239,700164641,41,915739,130243,597052,19,14,619,2690,16,5,129624,594362,3,9,89458,1690853,2775,410,7657,3,0,9,0,0,5,0
Bacteroides_ovatus_58035,700117239,700171441,55,923067,130895,601825,24,11,366,1772,10,1,130529,600053,14,10,90484,1706840,2835,228,5082,6,0,10,0,0,1,0
Bacteroides_ovatus_58035,700117239,700171648,1881,887071,125746,578298,720,355,30089,139090,693,293,95657,439208,27,62,66098,1249483,2043,21167,395455,648,1,60,1,0,293,0
Bacteroides_ovatus_58035,700117239,ERR911967,138,933513,132716,608700,63,18,1520,6806,59,8,131196,601894,4,10,90516,1712331,2835,1043,19354,21,0,10,0,0,8,0
Bacteroides_ovatus_58035,700117239,ERR912031,304,924154,131385,602600,131,68,5876,25740,105,43,125509,576860,26,25,86754,1641093,2733,3854,73273,93,0,25,0,0,43,0
Bacteroides_ovatus_58035,700117239,ERR912193,557,930223,132206,606528,195,124,10288,47344,180,96,121918,559184,15,28,83996,1590904,2652,7239,134595,198,0,28,0,0,96,0
Bacteroides_ovatus_58035,700117766,ERR911986,1222,842854,119668,549540,485,234,18312,82182,458,190,101356,467358,27,44,70717,1329194,2163,12058,234131,357,0,44,0,0,190,0
Bacteroides_ovatus_58035,700121919,700173546,211,858644,122028,559715,83,38,2105,9504,75,27,119923,550211,8,11,82847,1565272,2514,1397,27091,24,0,11,0,0,27,0
Bacteroides_ovatus_58035,700121919,ERR911997,205,869040,123474,566560,79,26,3646,16230,68,16,119828,550330,11,10,82757,1565737,2496,2441,46183,66,0,10,0,0,16,0
Bacteroides_ovatus_58035,700121919,ERR912004,1087,867335,123225,565444,429,190,14903,69042,402,164,108322,496402,27,26,74394,1412535,2277,10678,196184,264,0,26,0,1,163,0
Bacteroides_ovatus_58035,700121919,ERR912033,820,852910,121067,555984,308,162,12552,58203,297,141,108515,497781,11,21,74698,1416374,2271,9073,165278,258,0,21,0,1,140,0
Bacteroides_ovatus_58035,700121919,ERR912064,211,857216,121727,558769,81,37,1968,8853,72,27,119759,549916,9,10,82859,1564372,2517,1326,25209,24,0,10,0,0,27,0
Bacteroides_ovatus_58035,700121919,ERR912113,214,856459,121659,558291,85,39,2617,11879,80,28,119042,546412,5,11,82234,1554503,2499,1804,33794,39,1,10,0,0,28,0
Bacteroides_ovatus_58035,700121919,ERR912114,310,868103,123339,565937,119,55,2877,13055,104,38,120462,552882,15,17,83184,1572942,2520,1946,37189,30,0,17,0,0,38,0
Bacteroides_ovatus_58035,700121919,ERR912181,536,855887,121565,557925,212,107,6859,31370,206,86,114706,526555,6,21,79374,1497879,2412,4621,89381,108,0,21,0,0,86,0
Bacteroides_ovatus_58035,700121919,SRR341651,908,859049,121832,560087,358,157,13847,64071,345,134,107985,496016,13,23,74426,1411375,2247,9977,181957,279,0,23,0,1,133,0
Bacteroides_ovatus_58035,700121919,SRR413629,264,857850,121853,559226,97,49,2463,11023,89,30,119390,548203,8,19,82532,1559557,2520,1623,31422,24,0,19,0,0,30,0
Bacteroides_ovatus_58035,700122108,700163030,1200,840967,119336,548151,458,255,19386,88416,430,185,99950,459735,28,70,69428,1307686,2091,13319,251554,375,1,69,0,0,185,0
Bacteroides_ovatus_58035,700122108,700163419,1434,839135,119260,547047,549,316,25658,117593,526,240,93602,429454,23,76,64676,1221730,1956,17639,334636,504,2,74,0,1,239,0
Bacteroides_ovatus_58035,700122108,700164792,1438,839142,119216,547082,550,315,25242,115930,529,235,93974,431152,21,80,64983,1226511,1962,17433,329859,498,1,79,0,0,235,0
Bacteroides_ovatus_58035,700122765,700123135,34,929392,132233,605991,9,17,647,2967,6,1,131586,603024,3,16,90585,1715685,2802,494,8404,3,0,16,0,0,1,0
Bacteroides_ovatus_58035,700122765,700161945,61,927773,131886,604927,25,20,1276,5738,22,6,130610,599189,3,14,90052,1704725,2790,921,16281,12,0,14,0,0,6,0
Bacteroides_ovatus_58035,700122765,700164641,27,914569,130125,596288,10,10,647,2991,6,1,129478,593297,4,9,89215,1687934,2742,500,8464,9,0,9,0,0,1,0
Bacteroides_ovatus_58035,700122765,700171441,101,920881,130658,600388,47,21,1969,9001,35,8,128689,591387,12,13,89072,1682305,2784,1375,25607,21,0,13,0,0,8,0
Bacteroides_ovatus_58035,700122765,ERR911967,124,930583,132376,606777,54,14,1558,7159,49,4,130818,599618,5,10,90074,1705990,2790,1137,20313,27,0,10,0,0,4,0
Bacteroides_ovatus_58035,700122765,ERR912031,285,921207,131043,600665,123,63,5331,23379,96,39,125712,577286,27,24,86773,1642388,2697,3486,66561,90,0,24,0,0,39,0
Bacteroides_ovatus_58035,700122765,ERR912193,543,927494,131891,604738,186,120,9391,43384,163,90,122500,561354,23,30,84267,1597176,2619,6647,123316,189,0,30,0,0,90,0
Bacteroides_ovatus_58035,700122860,700123959,1030,861380,122390,561544,393,192,17785,81442,388,139,104605,480102,5,53,72223,1365914,2169,12371,231631,324,0,53,0,0,139,0
Bacteroides_ovatus_58035,700122860,ERR912038,978,861263,122366,561435,383,180,16930,77572,378,133,105436,483863,5,47,72799,1376621,2169,11788,220595,333,0,47,0,0,133,0
Bacteroides_ovatus_58035,700122860,ERR912052,1021,858704,122033,559727,398,195,17553,80129,393,140,104480,479598,5,55,72154,1364459,2181,12172,227897,318,0,55,0,0,140,0
Bacteroides_ovatus_58035,700122860,ERR912187,1020,859574,122147,560350,409,177,16856,76995,393,129,105291,483355,16,48,72709,1375172,2184,11694,218970,321,1,47,0,0,129,0
Bacteroides_ovatus_58035,700123135,700161945,51,929483,132117,606047,16,25,609,2652,16,5,131508,603395,0,20,90782,1716586,2817,405,7548,3,0,20,0,0,5,0
Bacteroides_ovatus_58035,700123135,700171441,91,922668,130873,601569,38,26,1234,5603,26,9,129639,595966,12,17,89867,1695217,2814,796,16001,12,0,17,0,0,9,0
Bacteroides_ovatus_58035,700123135,ERR911967,110,933414,132774,608627,45,15,901,4129,43,3,131873,604498,2,12,90892,1719776,2826,629,11740,18,0,12,0,0,3,0
Bacteroides_ovatus_58035,700123135,ERR912031,282,924080,131445,602545,116,70,5426,23795,101,40,126019,578750,15,30,87032,1646497,2721,3540,67752,93,0,30,0,0,40,0
Bacteroides_ovatus_58035,700123135,ERR912193,533,929985,132222,606361,177,125,9389,43358,163,89,122833,563003,14,36,84548,1601815,2646,6643,123242,189,0,36,0,0,89,0
Bacteroides_ovatus_58035,700123959,ERR912038,123,864278,122764,563386,34,41,1974,9134,33,16,120790,554252,1,25,83507,1576717,2532,1426,25946,30,0,25,0,0,16,0
Bacteroides_ovatus_58035,700123959,ERR912052,61,862169,122453,562001,9,20,269,1222,8,3,122184,560779,1,17,84576,1595208,2553,173,3487,6,0,17,0,0,3,0
Bacteroides_ovatus_58035,700123959,ERR912187,166,862014,122446,561892,56,40,2294,10630,40,16,120152,551262,16,24,83072,1568194,2520,1662,30180,48,1,23,0,0,16,0
Bacteroides_ovatus_58035,700161342,700171648,371,882620,125165,575403,135,87,5783,26453,132,71,119382,548950,3,16,82666,1561622,2562,4096,75164,99,0,16,0,0,71,0
Bacteroides_ovatus_58035,700161342,700172813,325,886445,126039,577920,117,81,5358,24458,115,68,120681,553462,2,13,83150,1574674,2562,3807,69474,93,0,13,0,0,68,0
Bacteroides_ovatus_58035,700161856,ERR912068,523,852505,120735,555686,191,110,6859,31187,187,85,113876,524499,4,25,79393,1491656,2448,4672,88775,114,0,25,0,0,85,0
Bacteroides_ovatus_58035,700161856,ERR912139,1125,857980,121479,559273,462,202,16454,74020,449,167,105025,485253,13,35,73921,1379627,2211,10708,211010,342,0,35,0,1,166,0
Bacteroides_ovatus_58035,700161945,700164641,44,914965,130087,596554,17,18,619,2690,16,5,129468,593864,1,13,89421,1689402,2769,410,7657,3,0,13,0,0,5,0
Bacteroides_ovatus_58035,700161945,700171441,58,922503,130802,601453,22,15,506,2402,13,1,130296,599051,9,14,90346,1703984,2823,336,6864,6,0,14,0,0,1,0
Bacteroides_ovatus_58035,700161945,ERR911967,140,931396,132334,607321,60,22,1510,6793,58,9,130824,600528,2,13,90365,1708396,2823,1039,19319,21,0,13,0,0,9,0
Bacteroides_ovatus_58035,700161945,ERR912031,294,922163,131020,601302,123,72,5899,25935,107,46,125121,575367,16,26,86573,1636804,2724,3887,73825,93,0,26,0,0,46,0
Bacteroides_ovatus_58035,700161945,ERR912193,558,928194,131842,605213,193,128,10249,47215,180,97,121593,557998,13,31,83863,1587500,2631,7230,134214,201,0,31,0,0,97,0
Bacteroides_ovatus_58035,700163030,700163419,558,848960,120457,553442,230,133,9680,44349,217,91,110777,509093,13,42,76860,1448043,2376,6563,126310,174,2,40,0,0,91,0
Bacteroides_ovatus_58035,700163030,700164792,550,847121,120126,552246,229,132,9741,44537,218,90,110385,507709,11,42,76821,1443951,2355,6602,126832,177,0,42,0,0,90,0
Bacteroides_ovatus_58035,700164354,700172393,51,849024,120614,553429,17,24,380,1663,4,1,120234,551766,13,23,83100,1569663,2535,201,4785,3,1,22,0,0,1,0
Bacteroides_ovatus_58035,700164354,ERR912127,55,855937,121644,557958,18,22,420,1797,6,1,121224,556161,12,21,83737,1582202,2544,221,5167,3,0,21,0,0,1,0
Bacteroides_ovatus_58035,700164354,SRR413556,171,852924,121190,556005,61,44,2086,9468,42,26,119104,546537,19,18,82257,1554837,2517,1407,26970,27,0,18,0,0,26,0
Bacteroides_ovatus_58035,700164641,700171441,81,909015,128997,592640,38,19,1249,5519,29,8,127748,587121,9,11,88575,1670028,2760,798,15747,12,0,11,0,0,8,0
Bacteroides_ovatus_58035,700164641,ERR911967,103,916078,130300,597276,46,8,871,3953,43,3,129429,593323,3,5,89304,1687899,2766,602,11242,15,0,5,0,0,3,0
Bacteroides_ovatus_58035,700164641,ERR912031,244,906920,128994,591305,100,59,5112,22342,80,35,123882,568963,20,24,85636,1618592,2661,3338,63598,90,0,24,0,0,35,0
Bacteroides_ovatus_58035,700164641,ERR912193,524,914036,129970,595937,177,117,9356,43203,163,89,120614,552734,14,28,83095,1572521,2586,6611,122809,189,0,28,0,0,89,0
Bacteroides_ovatus_58035,700171441,ERR911967,181,924730,131126,602908,83,23,2133,9731,69,10,128993,593177,14,13,89473,1687241,2817,1428,27735,30,0,13,0,0,10,0
Bacteroides_ovatus_58035,700171441,ERR912031,336,915593,129829,596954,143,74,6614,29263,118,48,123215,567691,25,26,85600,1614758,2715,4364,83323,102,0,26,0,0,48,0
Bacteroides_ovatus_58035,700171441,ERR912193,593,921742,130671,600947,209,129,11226,51540,190,98,119445,549407,19,31,82768,1562822,2631,7833,146580,207,0,31,0,0,98,0
Bacteroides_ovatus_58035,700171648,700172813,52,881749,125045,574812,20,8,495,2244,19,4,124550,572568,1,4,86393,1628656,2655,325,6392,15,0,4,0,0,4,0
Bacteroides_ovatus_58035,700172132,SRR413659,829,831501,118185,542080,304,193,19348,88852,289,145,98837,453228,15,48,68487,1289178,2019,13035,253092,429,0,48,0,0,145,0
Bacteroides_ovatus_58035,700172393,ERR912127,41,854064,121302,556743,11,22,218,950,4,1,121084,555793,7,21,83697,1581135,2547,156,2694,0,1,20,0,0,1,0
Bacteroides_ovatus_58035,700172393,SRR413556,160,851240,120858,554908,55,46,1350,6347,34,22,119508,548561,21,24,82603,1560554,2526,979,18044,18,1,23,0,0,22,0
Bacteroides_ovatus_58035,700173546,ERR911997,305,872248,123940,568573,126,46,3308,15063,123,37,120632,553510,3,9,83420,1574566,2544,2279,42862,48,0,9,0,0,37,0
Bacteroides_ovatus_58035,700173546,ERR912004,905,871115,123801,567842,365,152,13750,64316,347,130,110051,503526,18,22,75634,1432643,2301,9988,182690,270,0,22,0,1,129,0
Bacteroides_ovatus_58035,700173546,ERR912033,665,855827,121524,557799,258,131,10518,49058,248,113,111006,508741,10,18,76517,1447375,2331,7685,139261,228,0,18,0,1,112,0
Bacteroides_ovatus_58035,700173546,ERR912114,90,872543,124006,568756,40,18,722,3330,34,9,123284,565426,6,9,85245,1608456,2577,499,9488,3,0,9,0,0,9,0
Bacteroides_ovatus_58035,700173546,ERR912181,339,859659,122106,560296,137,76,4833,22200,133,64,117273,538096,4,12,81246,1530570,2472,3266,63250,84,0,12,0,0,64,0
Bacteroides_ovatus_58035,700173546,SRR341651,735,862502,122340,562273,302,120,11276,52435,290,101,111064,509838,12,19,76735,1450463,2316,8197,148871,237,0,19,0,1,100,0
Bacteroides_ovatus_58035,700173546,SRR413629,79,860578,122283,560945,27,18,413,1748,21,3,121870,559197,6,15,84313,1590707,2571,229,5015,0,0,15,0,0,3,0
Bacteroides_ovatus_58035,ERR911967,ERR912031,386,931377,132403,607311,167,70,6524,28873,151,46,125879,578438,16,24,87012,1645554,2748,4337,82171,111,0,24,0,0,46,0
Bacteroides_ovatus_58035,ERR911967,ERR912193,623,934421,132810,609257,222,122,10301,47555,206,92,122509,561702,16,30,84400,1598045,2661,7284,135174,207,0,30,0,0,92,0
Bacteroides_ovatus_58035,ERR911997,ERR912004,1330,920525,130790,600281,547,199,18803,87747,542,176,111987,512534,5,23,76903,1458314,2385,13480,249413,348,0,23,0,1,175,0
Bacteroides_ovatus_58035,ERR911997,ERR912033,988,871080,123633,567839,390,170,14707,68411,385,153,108926,499428,5,17,75048,1420899,2337,10633,194312,288,0,17,0,1,152,0
Bacteroides_ovatus_58035,ERR911997,ERR912064,297,874000,124060,569721,123,44,3278,14880,122,37,120782,554841,1,7,83731,1578206,2586,2262,42327,51,0,7,0,0,37,0
Bacteroides_ovatus_58035,ERR911997,ERR912113,295,875650,124374,570832,121,45,3268,14834,120,37,121106,555998,1,8,83805,1581597,2592,2252,42199,51,1,7,0,0,37,0
Bacteroides_ovatus_58035,ERR911997,ERR912114,420,920700,130839,600376,178,61,4279,19590,175,48,126560,580786,3,13,87436,1652255,2667,2960,55747,63,0,13,0,0,48,0
Bacteroides_ovatus_58035,ERR911997,ERR912181,692,876467,124447,571341,285,121,9064,41528,285,105,115383,529813,0,16,79997,1506961,2481,6156,118272,156,0,16,0,0,105,0
Bacteroides_ovatus_58035,ERR912004,ERR912033,286,872312,123794,568636,122,42,4454,20914,113,26,119340,547722,9,16,82707,1557918,2541,3145,59519,78,0,16,0,0,26,0
Bacteroides_ovatus_58035,ERR912004,ERR912064,907,872921,123927,569019,359,154,14544,68165,348,132,109383,500854,11,22,75402,1424817,2343,10509,193713,273,0,22,0,1,131,0
Bacteroides_ovatus_58035,ERR912004,ERR912113,913,874652,124256,570186,362,155,14193,66401,349,132,110063,503785,13,23,75725,1433290,2340,10262,188659,282,1,22,0,1,131,0
Bacteroides_ovatus_58035,ERR912004,ERR912114,1035,919186,130612,599390,418,168,14485,67237,404,142,116127,532153,14,26,79870,1514138,2451,10440,191013,258,0,26,0,1,141,0
Bacteroides_ovatus_58035,ERR912004,ERR912181,1131,875633,124327,570807,441,204,17254,80313,430,179,107073,490494,11,25,73867,1395338,2277,12254,228337,348,0,25,0,1,178,0
Bacteroides_ovatus_58035,ERR912031,ERR912193,706,925601,131573,603497,262,151,13949,63011,238,119,117624,540486,24,32,81225,1537647,2586,9560,179218,255,0,32,0,0,119,0
Bacteroides_ovatus_58035,ERR912033,ERR912064,677,863465,122543,562787,259,134,11223,52344,252,115,111320,510443,7,19,76885,1452083,2361,8135,148660,237,0,19,0,1,114,0
Bacteroides_ovatus_58035,ERR912033,ERR912113,688,863210,122537,562654,264,137,12437,57650,257,117,110100,505004,7,20,76000,1436669,2343,8959,163730,261,1,19,0,1,116,0
Bacteroides_ovatus_58035,ERR912033,ERR912114,779,870230,123515,567255,302,149,13264,61528,294,125,110251,505727,8,24,76116,1438719,2346,9532,174797,255,0,24,0,1,124,0
Bacteroides_ovatus_58035,ERR912033,ERR912181,1018,862862,122487,562413,396,209,17393,80605,389,185,105094,481808,7,24,72591,1370616,2217,12316,229124,375,0,24,0,1,184,0
Bacteroides_ovatus_58035,ERR912038,ERR912052,81,871040,123747,567758,24,35,1465,6631,23,11,122282,561127,1,24,84574,1596230,2577,1043,18832,18,0,24,0,0,11,0
Bacteroides_ovatus_58035,ERR912038,ERR912187,60,871133,123744,567841,23,11,488,2191,6,1,123256,565650,17,10,85272,1609092,2586,335,6226,12,1,9,0,0,1,0
Bacteroides_ovatus_58035,ERR912052,ERR912187,131,869841,123567,566991,45,35,1824,8357,33,13,121743,558634,12,22,84164,1589170,2568,1319,23716,36,1,21,0,0,13,0
Bacteroides_ovatus_58035,ERR912061,ERR912179,942,835614,118261,544741,347,206,17041,77328,317,143,101220,467413,30,63,70772,1329256,2211,11469,220209,306,0,63,0,0,143,0
Bacteroides_ovatus_58035,ERR912064,ERR912114,87,874537,124162,570065,35,18,684,3198,31,9,123478,566867,4,9,85561,1612418,2622,483,9105,6,0,9,0,0,9,0
Bacteroides_ovatus_58035,ERR912064,ERR912181,336,867364,123134,565328,133,76,5043,23140,132,65,118091,542188,1,11,81949,1542095,2520,3394,65936,90,0,11,0,0,65,0
Bacteroides_ovatus_58035,ERR912068,ERR912139,1042,872832,123871,569045,428,200,15431,69024,415,167,108440,500021,13,33,75863,1421923,2277,9980,196765,327,0,33,0,1,166,0
Bacteroides_ovatus_58035,ERR912081,ERR912179,878,841342,119072,548418,334,212,21063,95802,324,154,98009,452616,10,58,68322,1287369,2157,14522,272488,396,1,57,0,0,154,0
Bacteroides_ovatus_58035,ERR912081,pluto3-11-0-0_,714,831337,117418,541846,280,176,11018,49349,246,111,106400,492497,34,65,74647,1400531,2313,7244,140596,207,1,64,0,0,111,0
Bacteroides_ovatus_58035,ERR912113,ERR912114,90,874740,124255,570226,37,20,713,3307,33,9,123542,566919,4,11,85496,1612645,2616,502,9413,6,1,10,0,0,9,0
Bacteroides_ovatus_58035,ERR912113,ERR912181,340,867107,123142,565204,136,80,4950,22658,133,63,118192,542546,3,17,81929,1543195,2514,3343,64541,90,1,16,0,0,63,0
Bacteroides_ovatus_58035,ERR912114,ERR912181,434,875604,124338,570747,185,86,5238,23984,182,71,119100,546763,3,15,82594,1555160,2535,3521,68347,84,0,15,0,0,71,0
Bacteroides_ovatus_58035,ERR912179,pluto3-11-0-0_,838,835908,118070,544912,322,180,10271,47293,296,121,107799,497619,26,59,74821,1415672,2364,7492,134219,168,0,59,0,0,121,0
Bacteroides_ovatus_58035,SRR341651,ERR911997,1088,907116,128603,591589,445,167,16375,75951,441,146,112228,515638,4,21,77562,1466970,2382,11681,215860,312,0,21,0,1,145,0
Bacteroides_ovatus_58035,SRR341651,ERR912004,394,907924,128717,592115,171,47,5199,24384,163,32,123518,567731,8,15,85677,1614921,2595,3666,69390,96,0,15,0,0,32,0
Bacteroides_ovatus_58035,SRR341651,ERR912033,193,863253,122330,562775,88,26,2322,10527,85,16,120008,552248,3,10,83570,1570624,2550,1492,30044,45,0,10,0,0,16,0
Bacteroides_ovatus_58035,SRR341651,ERR912038,2164,865082,122601,564004,871,347,40169,181397,859,301,82432,382607,12,46,58637,1087327,1857,26561,516928,702,0,46,0,2,299,0
Bacteroides_ovatus_58035,SRR341651,ERR912064,744,864576,122527,563630,303,123,11286,52757,291,102,111241,510873,12,21,76999,1453274,2346,8233,149789,249,0,21,0,1,101,0
Bacteroides_ovatus_58035,SRR341651,ERR912113,749,865977,122817,564555,300,125,11886,55394,292,103,110931,509161,8,22,76641,1448487,2355,8637,157296,249,1,21,0,1,102,0
Bacteroides_ovatus_58035,SRR341651,ERR912114,841,906267,128498,591006,341,130,13762,63905,335,107,114736,527101,6,23,79320,1499577,2406,9868,181580,267,0,23,0,1,106,0
Bacteroides_ovatus_58035,SRR341651,ERR912181,979,866509,122820,564897,390,181,15816,73662,381,154,107004,491235,9,27,74023,1397408,2274,11339,209320,327,0,27,0,1,153,0
Bacteroides_ovatus_58035,SRR341651,SRR413629,782,866892,122934,565201,310,135,11983,55744,286,109,110951,509457,24,26,76646,1449385,2340,8671,158303,258,0,26,0,1,108,0
Bacteroides_ovatus_58035,SRR413556,ERR912127,221,904892,128597,590035,77,51,1961,9040,49,26,126636,580995,28,25,87422,1652902,2661,1384,25709,27,0,25,0,0,26,0
Bacteroides_ovatus_58035,SRR413577,ERR912183,1165,860058,122072,560809,473,209,18488,84994,449,159,103584,475815,24,50,71933,1353448,2064,12713,241843,426,0,50,0,0,159,0
Bacteroides_ovatus_58035,SRR413577,SRR413641,81,909470,129254,593081,33,14,490,2473,20,3,128764,590608,13,11,88916,1680280,2628,381,7032,6,0,11,0,0,3,0
Bacteroides_ovatus_58035,SRR413629,ERR911997,373,876344,124502,571308,149,58,3761,16967,146,43,120741,554341,3,15,83489,1576954,2580,2548,48293,60,0,15,0,0,43,0
Bacteroides_ovatus_58035,SRR413629,ERR912004,941,875310,124374,570650,369,165,14523,67845,353,135,109851,502805,16,30,75489,1430577,2349,10472,192793,270,0,30,0,1,134,0
Bacteroides_ovatus_58035,SRR413629,ERR912033,714,862969,122519,562499,269,145,11003,51311,244,115,111516,511188,25,30,76861,1454348,2355,8006,145681,246,0,30,0,1,114,0
Bacteroides_ovatus_58035,SRR413629,ERR912064,79,869510,123476,566791,25,18,413,1736,21,3,123063,565055,4,15,85272,1607268,2625,224,4984,0,0,15,0,0,3,0
Bacteroides_ovatus_58035,SRR413629,ERR912113,77,867445,123231,565454,25,19,413,1736,21,3,122818,563718,4,16,85043,1603498,2613,224,4984,0,1,15,0,0,3,0
Bacteroides_ovatus_58035,SRR413629,ERR912114,139,876808,124591,571617,48,33,929,4166,41,11,123662,567451,7,22,85485,1614246,2622,615,11877,6,0,22,0,0,11,0
Bacteroides_ovatus_58035,SRR413629,ERR912181,417,867094,123166,565207,163,89,5925,27088,160,68,117241,538119,3,21,81317,1530532,2508,3931,77228,105,0,21,0,0,68,0
Bacteroides_ovatus_58035,SRR413641,ERR912183,1103,868331,123318,566219,446,197,20056,91932,437,163,103262,474287,9,34,71736,1349070,2055,13675,261665,456,0,34,0,0,163,0
