species_name,sample 1,sample 2,core_diff,core_len,core_len_4D,core_len_1D,core_diff_4D,core_diff_1D,recomb_len_4D,recomb_len_1D,recomb_diff_4D,recomb_diff_1D,clonal_len_4D,clonal_len_1D,clonal_diff_4D,clonal_diff_1D,clonal_n,clonal_m,clonal_nn,recomb_n,recomb_m,recomb_nn,clonal_mut_n,clonal_mut_m,clonal_mut_nn,recomb_mut_n,recomb_mut_m,recomb_mut_nn
Bacteroides_stercoris_56735,700013603,700013715,5418,2187553,329492,1426863,2244,987,66066,281976,2226,934,263426,1144887,18,53,150879,3277719,6063,35961,808533,1434,0,53,0,2,931,1
Bacteroides_stercoris_56735,700013603,700016210,304,2191754,330273,1429690,110,91,1673,6953,93,50,328600,1422737,17,41,186313,4074434,7464,811,20000,48,2,39,0,0,50,0
Bacteroides_stercoris_56735,700013603,700037649,1141,2194497,330686,1431474,442,221,12924,55357,426,186,317762,1376117,16,35,180118,3941021,7212,7234,158531,306,0,35,0,1,185,0
Bacteroides_stercoris_56735,700013603,700038493,2990,2194803,330721,1431662,1201,507,39255,169310,1182,441,291466,1262352,19,66,165836,3614587,6633,21520,485510,900,3,63,0,0,440,1
Bacteroides_stercoris_56735,700013603,700038870,2994,2157056,324868,1406798,1215,557,41184,177603,1195,479,283684,1229195,20,78,161475,3519600,6510,23000,508900,909,1,77,0,1,477,1
Bacteroides_stercoris_56735,700013603,700098669,777,2173821,326936,1417677,332,140,7687,32307,315,103,319249,1385370,17,37,182259,3966576,7275,3855,92874,192,1,36,0,0,103,0
Bacteroides_stercoris_56735,700013603,700111156,611,2181198,328711,1422945,224,142,5199,21519,208,89,323512,1401426,16,53,183594,4013307,7377,2558,61879,120,1,51,1,1,88,0
Bacteroides_stercoris_56735,700013603,700164792,989,2192742,330399,1430332,405,214,10320,43887,388,161,320079,1386445,17,53,181655,3970423,7257,5534,125890,237,2,51,0,0,161,0
Bacteroides_stercoris_56735,700013603,700172813,983,2193889,330588,1431078,404,209,10280,43709,389,161,320308,1387369,15,48,181787,3973051,7269,5493,125400,234,0,47,1,0,161,0
Bacteroides_stercoris_56735,700013603,ERR911960,2984,2193945,330590,1431160,1211,551,40175,173166,1185,475,290415,1257994,26,76,164819,3602581,6582,22441,496157,900,1,74,1,1,473,1
Bacteroides_stercoris_56735,700013603,ERR912198,68,2192979,330467,1430483,15,41,107,456,2,2,330360,1430027,13,39,187103,4095478,7500,66,1302,0,1,38,0,0,2,0
Bacteroides_stercoris_56735,700013603,SRR341646,413,2136971,319705,1393125,174,81,5714,24958,163,52,313991,1368167,11,29,181059,3916092,7350,3262,71531,81,1,28,0,0,51,1
Bacteroides_stercoris_56735,700013603,SRR413558,978,2194556,330690,1431585,398,212,10383,44169,380,160,320307,1387416,18,52,181758,3973242,7248,5554,126722,231,4,48,0,0,160,0
Bacteroides_stercoris_56735,700013603,SRR413594,1074,2195280,330830,1432035,436,182,14321,61835,424,157,316509,1370200,12,25,179445,3923943,7212,7953,177279,273,0,25,0,0,157,0
Bacteroides_stercoris_56735,700013672,700106170,1704,2144264,322989,1398671,647,375,23116,99560,588,233,299873,1299111,59,142,170348,3720280,6705,12870,285276,534,4,138,0,0,233,0
Bacteroides_stercoris_56735,700013672,pluto3-11-0-0_,3609,2107944,317136,1374798,1447,670,54029,229116,1389,529,263107,1145682,58,141,151625,3279385,6036,28830,657342,1176,2,139,0,1,527,1
Bacteroides_stercoris_56735,700013715,700016210,5346,2188021,329512,1427131,2214,992,65759,280703,2193,931,263753,1146428,21,61,151203,3281985,6096,35823,804852,1434,2,59,0,2,928,1
Bacteroides_stercoris_56735,700013715,700037649,6258,2189174,329669,1427884,2591,1131,76578,327484,2573,1079,253091,1100400,18,52,145057,3150314,5829,42061,938681,1710,0,52,0,3,1075,1
Bacteroides_stercoris_56735,700013715,700038493,7309,2189999,329751,1428416,2988,1311,91114,391398,2966,1230,238637,1037018,22,81,136945,2968559,5550,50259,1121925,2010,2,79,0,2,1228,0
Bacteroides_stercoris_56735,700013715,700038870,7038,2155096,324427,1405433,2899,1266,92199,396218,2873,1190,232228,1009215,26,76,133319,2888935,5391,51156,1135440,2058,1,75,0,3,1185,2
Bacteroides_stercoris_56735,700013715,700098669,5497,2171561,326453,1416193,2265,984,66742,285126,2247,924,259711,1131067,18,60,149608,3237566,6027,36453,817455,1470,1,59,0,2,921,1
Bacteroides_stercoris_56735,700013715,700105049,5411,2184774,328848,1424969,2237,1000,65421,279356,2216,942,263427,1145613,21,58,151130,3279601,6108,35677,800951,1440,1,56,1,2,939,1
Bacteroides_stercoris_56735,700013715,700111156,5191,2176937,327853,1420035,2145,955,61882,264310,2119,901,265971,1155725,26,54,152253,3308757,6165,33754,757823,1353,2,51,1,2,898,1
Bacteroides_stercoris_56735,700013715,700164792,5481,2187927,329460,1427077,2289,986,66797,285003,2265,929,262663,1142074,24,57,150637,3269546,6039,36369,817158,1482,2,55,0,2,926,1
Bacteroides_stercoris_56735,700013715,700172813,5495,2189046,329652,1427829,2289,991,66764,284637,2269,935,262888,1143192,20,56,150800,3272698,6078,36286,816167,1458,0,55,1,2,932,1
Bacteroides_stercoris_56735,700013715,ERR911960,7209,2187212,329341,1426638,2978,1281,91608,393379,2950,1201,237733,1033259,28,80,136155,2958162,5460,50729,1127368,2040,1,78,1,3,1196,2
Bacteroides_stercoris_56735,700013715,ERR912198,5450,2186256,329230,1425966,2243,1004,64814,276520,2227,940,264416,1149446,16,64,151549,3290705,6084,35248,792893,1419,0,64,0,3,936,1
Bacteroides_stercoris_56735,700013715,SRR341646,5418,2133892,319168,1391024,2231,960,68634,295969,2209,905,250534,1095055,22,55,145703,3133507,5955,38475,847926,1506,0,55,0,3,900,2
Bacteroides_stercoris_56735,700013715,SRR413558,5513,2189127,329683,1427900,2303,997,67379,287341,2285,952,262304,1140559,18,45,150427,3265229,6021,36601,823934,1488,3,42,0,3,948,1
Bacteroides_stercoris_56735,700013715,SRR413594,6180,2189504,329755,1428158,2579,1100,77928,332677,2569,1066,251827,1095481,10,34,144593,3136006,5844,42498,953871,1662,0,34,0,2,1063,1
Bacteroides_stercoris_56735,700014386,700161945,2041,2199764,331059,1434808,853,332,28642,123630,826,267,302417,1311178,27,65,172173,3754383,6978,15836,354391,663,2,63,0,0,267,0
Bacteroides_stercoris_56735,700014386,ERR911956,2028,2188464,329672,1427389,846,327,28545,122910,815,269,301127,1304479,31,58,171238,3735242,6957,15708,352371,651,2,56,0,0,269,0
Bacteroides_stercoris_56735,700014386,ERR911974,4182,2201925,331741,1436291,1744,714,55182,237865,1725,631,276559,1198426,19,83,157503,3431328,6447,30421,681998,1176,1,82,0,1,630,0
Bacteroides_stercoris_56735,700014386,ERR912003,3454,2183856,329026,1424481,1402,596,50531,217024,1369,510,278495,1207457,33,86,158621,3457282,6468,27746,622192,1134,1,85,0,1,509,0
Bacteroides_stercoris_56735,700014386,SRR341709,2357,2177136,327770,1419828,967,415,34610,149296,943,337,293160,1270532,24,78,166915,3637892,6789,19209,427890,789,2,76,0,0,337,0
Bacteroides_stercoris_56735,700014724,1089275-24-28-0_,1076,2147789,323352,1400702,392,238,11987,50162,351,135,311365,1350540,41,103,177448,3866855,7317,6261,143982,243,3,100,0,1,134,0
Bacteroides_stercoris_56735,700014724,700024711,1485,2132007,320844,1390252,551,298,15120,63441,517,224,305724,1326811,34,74,174631,3798629,7173,7567,182411,345,4,70,0,1,223,0
Bacteroides_stercoris_56735,700014724,700035157,2272,2129149,320486,1388399,887,413,34750,148985,854,301,285736,1239414,33,112,162776,3548809,6657,19220,426889,846,5,107,0,0,301,0
Bacteroides_stercoris_56735,700014724,700096380,2416,2145024,322934,1398840,915,472,31526,132580,886,378,291408,1266260,29,94,166942,3625097,6741,16599,380406,735,3,91,0,4,374,0
Bacteroides_stercoris_56735,700014724,700106325,1022,2146654,323131,1399788,388,239,10496,44345,353,148,312635,1355443,35,91,178119,3880908,7302,5322,127449,264,5,86,0,0,148,0
Bacteroides_stercoris_56735,700014724,700113810,1238,2154013,324362,1404742,448,263,15324,66022,406,155,309038,1338720,42,108,175712,3833218,7230,8397,189342,327,2,106,0,1,154,0
Bacteroides_stercoris_56735,700014724,700114218,2326,2134579,321254,1392067,942,427,25940,109649,910,332,295314,1282418,32,95,169168,3671186,6900,13443,314925,579,5,90,0,2,330,0
Bacteroides_stercoris_56735,700014724,700116865,5369,2152753,324147,1403913,2161,932,81979,350772,2128,812,242168,1053141,33,120,139279,3014378,5766,44729,1005802,1785,3,117,0,4,808,0
Bacteroides_stercoris_56735,700014724,700171679,2519,2159539,325096,1408312,1013,468,28596,120620,971,364,296500,1287692,42,104,169924,3686195,6957,14727,346518,615,2,102,0,2,362,0
Bacteroides_stercoris_56735,700014724,700172346,1662,2139744,321968,1395335,622,318,21618,91450,593,230,300350,1303885,29,88,171437,3733147,7071,11452,262469,429,4,84,0,2,228,0
Bacteroides_stercoris_56735,700014724,ERR912001,1420,2159076,325026,1408016,547,280,14755,62347,503,176,310271,1345669,44,104,176762,3852982,7263,7824,178902,315,6,98,0,1,175,0
Bacteroides_stercoris_56735,700014724,ERR912018,1960,2157505,324789,1406964,775,404,24793,105900,733,276,299996,1301064,42,128,171016,3725120,7056,13438,303740,522,5,123,0,1,275,0
Bacteroides_stercoris_56735,700014724,ERR912022,1926,2152426,323932,1403642,774,375,25293,108140,733,273,298639,1295502,41,102,170387,3709072,7047,13676,310216,528,3,99,0,1,272,0
Bacteroides_stercoris_56735,700015250,700032133,7021,2151644,323938,1403211,2894,1252,95984,410671,2868,1167,227954,992540,26,85,130836,2841435,5349,53235,1176768,2010,0,85,0,3,1164,0
Bacteroides_stercoris_56735,700015415,SRR413589,131,2183237,328274,1423721,50,37,1446,6641,33,7,326828,1417080,17,30,186270,4057302,7668,867,19005,51,0,30,0,0,7,0
Bacteroides_stercoris_56735,700016210,700037649,1234,2193799,330516,1430998,482,250,12191,52380,465,205,318325,1378618,17,45,180599,3947992,7263,6809,150052,279,2,42,1,1,204,0
Bacteroides_stercoris_56735,700016210,700038493,3045,2194463,330594,1431423,1220,547,39219,169162,1195,468,291375,1262261,25,79,165941,3614194,6648,21516,485064,906,5,74,0,0,467,1
Bacteroides_stercoris_56735,700016210,700038870,3234,2156937,324793,1406702,1310,606,42369,182370,1288,527,282424,1224332,22,79,161010,3505524,6462,23550,522597,963,3,76,0,1,525,1
Bacteroides_stercoris_56735,700016210,700098669,859,2171993,326585,1416484,347,176,7607,31997,333,130,318978,1384487,14,46,182232,3963948,7281,3827,91969,195,3,43,0,0,130,0
Bacteroides_stercoris_56735,700016210,700105049,296,2188751,329584,1427658,106,93,1764,7393,92,51,327820,1420265,14,42,186188,4067107,7500,879,21252,48,3,38,1,0,51,0
Bacteroides_stercoris_56735,700016210,700111156,601,2179646,328397,1421891,219,158,5057,21037,201,92,323340,1400854,18,66,183627,4011546,7389,2528,60460,123,3,62,1,1,91,0
Bacteroides_stercoris_56735,700016210,700164792,1016,2192142,330238,1429921,416,224,10824,46047,397,171,319414,1383874,19,53,181480,3962873,7269,5788,132113,240,4,49,0,0,171,0
Bacteroides_stercoris_56735,700016210,700172813,1016,2193438,330458,1430775,412,226,10752,45750,396,169,319706,1385025,16,57,181620,3966177,7278,5749,131264,237,2,53,2,0,169,0
Bacteroides_stercoris_56735,700016210,ERR911960,3238,2190625,330001,1428960,1308,611,41814,179945,1282,530,288187,1249015,26,81,163847,3576652,6546,23235,515652,948,3,76,2,1,528,1
Bacteroides_stercoris_56735,700016210,ERR912198,310,2190057,329947,1428531,109,94,1682,6992,94,51,328265,1421539,15,43,186226,4070921,7470,820,20108,48,3,39,1,0,51,0
Bacteroides_stercoris_56735,700016210,SRR341646,624,2134365,319238,1391395,255,131,7210,31220,242,97,312028,1360175,13,34,180202,3892991,7332,4013,89518,129,1,33,0,1,95,1
Bacteroides_stercoris_56735,700016210,SRR413558,1000,2191865,330200,1429777,408,214,10975,46686,394,168,319225,1383091,14,46,181333,3960677,7263,5874,133938,246,4,42,0,0,168,0
Bacteroides_stercoris_56735,700016210,SRR413594,1318,2192286,330289,1430062,529,238,16064,69139,516,208,314225,1360923,13,30,178461,3897141,7167,8819,198265,333,2,28,0,0,208,0
Bacteroides_stercoris_56735,700016542,700108161,111,2203876,332042,1437580,28,60,220,852,5,0,331822,1436728,23,60,188197,4114355,7632,89,2455,12,4,56,0,0,0,0
Bacteroides_stercoris_56735,700016542,700166862,731,2200793,331547,1435566,269,186,7917,33390,248,118,323630,1402176,21,68,184022,4015048,7458,3939,96054,177,3,65,0,0,118,0
Bacteroides_stercoris_56735,700016542,SRR341638,118,2189676,329158,1428066,23,72,218,887,4,3,328940,1427179,19,69,187310,4086598,7629,90,2565,6,4,64,1,0,3,0
Bacteroides_stercoris_56735,700016542,SRR413621,278,2207044,332437,1439627,82,103,1996,8734,60,28,330441,1430893,22,75,187469,4097602,7608,1045,25097,60,3,72,0,0,28,0
Bacteroides_stercoris_56735,700016610,700023337,1265,2201392,331172,1435823,517,228,19588,83628,502,181,311584,1352195,15,47,177731,3871501,7353,10673,239815,396,1,46,0,1,180,0
Bacteroides_stercoris_56735,700016610,700033922,2318,2209514,332533,1441181,932,428,33641,143618,912,363,298892,1297563,20,65,170800,3714881,7008,18186,411918,750,0,65,0,2,360,1
Bacteroides_stercoris_56735,700016610,700035533,4382,2198738,330777,1434073,1832,685,68174,290950,1821,619,262603,1143123,11,66,150969,3272211,6189,37184,834163,1503,0,66,0,0,619,0
Bacteroides_stercoris_56735,700016610,700097291,2340,2172070,326885,1416780,972,427,38291,164426,960,375,288594,1252354,12,52,164562,3585906,6594,21166,471272,840,1,51,0,1,374,0
Bacteroides_stercoris_56735,700016610,700097906,240,2212275,332935,1443005,100,55,3151,13342,83,23,329784,1429663,17,32,187566,4093722,7701,1673,38293,60,1,31,0,0,23,0
Bacteroides_stercoris_56735,700016610,700116730,354,2204374,331714,1437799,146,81,4125,17372,125,36,327589,1420427,21,45,186487,4067132,7662,2111,49915,90,0,45,0,0,36,0
Bacteroides_stercoris_56735,700016610,700161533,259,2207716,332188,1440001,97,70,3450,14514,85,27,328738,1425487,12,43,187096,4081682,7683,1788,41685,69,1,42,0,0,27,0
Bacteroides_stercoris_56735,700016610,700163628,1146,2199786,330738,1434736,469,205,17245,73740,460,163,313493,1360996,9,42,179201,3896362,7425,9194,211708,318,1,41,0,0,163,0
Bacteroides_stercoris_56735,700016610,ERR911990,2676,2190946,329586,1428960,1058,508,37299,158555,1036,442,292287,1270405,22,66,167771,3636598,6846,19882,454910,873,1,65,0,3,439,0
Bacteroides_stercoris_56735,700016610,ERR911993,733,2193409,329979,1430560,293,145,10051,42262,277,104,319928,1388298,16,41,182452,3974903,7539,5369,121228,189,2,39,0,1,103,0
Bacteroides_stercoris_56735,700016610,ERR912165,261,2207790,332172,1440054,103,65,3181,13453,85,27,328991,1426601,18,38,187241,4084864,7698,1684,38600,75,0,38,0,1,26,0
Bacteroides_stercoris_56735,700016610,SRR413601,258,2181301,328204,1422621,96,67,3151,13293,84,24,325053,1409328,12,43,185167,4035209,7608,1664,38152,63,0,43,0,0,24,0
Bacteroides_stercoris_56735,700016610,SRR413607,257,2210912,332716,1442147,97,65,3161,13372,83,24,329555,1428775,14,41,187448,4091197,7680,1678,38369,69,0,41,0,0,24,0
Bacteroides_stercoris_56735,700016610,SRR413614,5533,2208062,332237,1440258,2169,1086,85547,369478,2108,914,246690,1070780,61,172,141657,3065022,5661,47243,1059073,2118,1,171,0,2,912,0
Bacteroides_stercoris_56735,700016610,SRR413618,255,2211809,332843,1442714,99,65,3171,13422,83,24,329672,1429292,16,41,187526,4092649,7701,1681,38519,66,0,41,0,0,24,0
Bacteroides_stercoris_56735,700016610,SRR413619,268,2211704,332828,1442652,102,66,3171,13383,84,23,329657,1429269,18,43,187542,4092564,7701,1677,38394,78,0,43,0,0,23,0
Bacteroides_stercoris_56735,700016960,ERR912095,253,2199975,330947,1434925,52,120,845,3637,19,9,330102,1431288,33,111,187817,4098262,7785,483,10407,21,5,106,0,0,9,0
Bacteroides_stercoris_56735,700023337,700033922,2859,2205871,332164,1438783,1166,519,40355,173029,1145,432,291809,1265754,21,87,166401,3624006,6855,22155,496026,906,1,86,0,1,430,1
Bacteroides_stercoris_56735,700023337,700035533,4974,2201375,331374,1435832,2074,767,75062,320533,2062,704,256312,1115299,12,63,147271,3192560,6066,40957,919004,1638,1,62,0,1,703,0
Bacteroides_stercoris_56735,700023337,700097291,2917,2172684,327181,1417153,1209,520,45633,196079,1191,460,281548,1221074,18,60,160203,3496548,6471,25428,561834,975,2,58,0,2,458,0
Bacteroides_stercoris_56735,700023337,700097906,1076,2208500,332556,1440511,435,200,16297,69772,417,160,316259,1370739,18,40,179859,3924918,7440,8940,200055,321,2,38,0,1,159,0
Bacteroides_stercoris_56735,700023337,700116730,1193,2207666,332444,1439978,481,229,17549,74941,460,177,314895,1365037,21,52,179204,3908491,7416,9509,214972,342,1,51,0,1,176,0
Bacteroides_stercoris_56735,700023337,700161533,1098,2203537,331699,1437264,432,213,16277,69704,416,163,315422,1367560,16,50,179468,3915778,7434,8939,199846,327,2,48,0,1,162,0
Bacteroides_stercoris_56735,700023337,700163628,1734,2202881,331467,1436780,708,306,25303,108700,696,263,306164,1328080,12,43,174547,3802424,7269,13926,311694,480,2,41,0,1,262,0
Bacteroides_stercoris_56735,700023337,ERR911990,3376,2191279,329861,1429161,1336,621,48388,206046,1313,543,281473,1223115,23,78,161523,3501183,6639,25994,591058,1086,2,76,0,1,542,0
Bacteroides_stercoris_56735,700023337,ERR911993,1548,2194326,330346,1431145,621,284,22666,96298,605,232,307680,1334847,16,52,175396,3821858,7287,12328,276125,441,3,49,0,1,231,0
Bacteroides_stercoris_56735,700023337,ERR912165,1090,2207961,332453,1440153,435,207,15998,68602,416,161,316455,1371551,19,46,179968,3927233,7452,8802,196680,324,1,45,0,1,160,0
Bacteroides_stercoris_56735,700023337,SRR413601,1073,2179770,328183,1421608,421,207,15876,67870,408,156,312307,1353738,13,51,177874,3875984,7356,8709,194583,318,1,50,0,1,155,0
Bacteroides_stercoris_56735,700023337,SRR413607,1093,2207030,332320,1439570,432,210,15997,68586,415,161,316323,1370984,17,49,179869,3925664,7419,8802,196632,324,1,48,0,1,160,0
Bacteroides_stercoris_56735,700023337,SRR413618,1093,2207895,332445,1440125,437,209,16305,69826,417,160,316140,1370299,20,49,179802,3923676,7419,8953,200192,333,1,48,0,1,159,0
Bacteroides_stercoris_56735,700023337,SRR413619,1097,2207490,332393,1439865,436,207,16278,69798,419,162,316115,1370067,17,45,179780,3922996,7425,8950,200108,336,1,44,0,1,161,0
Bacteroides_stercoris_56735,700023578,700099886,5144,2186561,328769,1426183,2054,982,67592,291646,2028,875,261177,1134537,26,107,149886,3247776,5949,37351,836093,1494,3,104,0,3,872,0
Bacteroides_stercoris_56735,700023578,700105882,3539,2183817,328433,1424293,1398,731,45007,194149,1377,622,283426,1230144,21,109,162240,3521814,6378,24766,556580,1101,2,107,0,2,620,0
Bacteroides_stercoris_56735,700024234,ERR911969,4148,2210789,332942,1441999,1712,750,75685,324404,1655,606,257257,1117595,57,144,147812,3198901,6072,41107,930350,1755,2,142,0,3,603,0
Bacteroides_stercoris_56735,700024615,700102043,1569,2162657,325608,1410544,609,307,24353,102047,582,229,301255,1308497,27,78,172216,3746498,6777,12571,293027,543,0,76,2,0,229,0
Bacteroides_stercoris_56735,700024615,700116505,1565,2159111,325030,1408197,616,305,23568,98652,593,230,301462,1309545,23,75,172299,3749526,6810,12204,283209,543,0,75,0,0,230,0
Bacteroides_stercoris_56735,700024711,1089275-24-28-0_,2223,2166757,326126,1413210,856,410,23099,97517,806,327,303027,1315693,50,83,173154,3766758,7167,11977,280097,477,3,79,1,2,325,0
Bacteroides_stercoris_56735,700024711,700035157,3456,2166996,326235,1413367,1365,592,46436,198480,1328,495,279799,1214887,37,97,159848,3478267,6546,25229,569125,1086,5,92,0,1,494,0
Bacteroides_stercoris_56735,700024711,700037405,1568,2178902,328017,1421197,586,318,15627,65560,551,237,312390,1355637,35,81,178303,3881282,7326,7811,188515,354,4,76,1,1,236,0
Bacteroides_stercoris_56735,700024711,700095213,1548,2181486,328314,1422792,589,303,15687,65815,552,235,312627,1356977,37,68,178480,3885134,7317,7855,189233,357,5,63,0,1,234,0
Bacteroides_stercoris_56735,700024711,700095717,1559,2178221,327916,1420723,591,304,15821,66429,556,236,312095,1354294,35,68,178156,3877388,7338,7917,191019,351,3,64,1,1,235,0
Bacteroides_stercoris_56735,700024711,700096380,3477,2163310,325608,1410949,1341,628,41063,172683,1310,553,284545,1238266,31,75,163485,3544701,6612,21373,495746,930,3,72,0,5,548,0
Bacteroides_stercoris_56735,700024711,700106325,1874,2167890,326369,1413853,749,368,20733,87527,712,298,305636,1326326,37,70,174600,3797199,7179,10512,251607,462,5,65,0,1,297,0
Bacteroides_stercoris_56735,700024711,700113810,2324,2164694,325973,1411870,898,422,25896,110456,849,331,300077,1301414,49,91,171081,3726129,7032,13719,317088,561,2,89,0,2,329,0
Bacteroides_stercoris_56735,700024711,700114218,3163,2171891,326933,1416632,1279,554,35791,150747,1242,483,291142,1265885,37,71,167232,3623592,6831,18356,433111,774,4,67,0,4,479,0
Bacteroides_stercoris_56735,700024711,700116865,6652,2175941,327594,1419255,2665,1129,92037,393214,2631,1028,235557,1026041,34,101,135935,2936554,5634,49842,1127787,2013,2,99,0,7,1021,0
Bacteroides_stercoris_56735,700024711,700117303,1562,2169634,326599,1415132,593,305,15619,65600,550,237,310980,1349532,43,68,177410,3863920,7266,7807,188639,354,4,64,0,1,236,0
Bacteroides_stercoris_56735,700024711,700167825,1538,2160140,325189,1409062,584,307,15366,64687,546,237,309823,1344375,38,70,176769,3849120,7236,7717,186005,339,2,68,0,1,236,0
Bacteroides_stercoris_56735,700024711,700171679,3351,2184582,328842,1424854,1345,590,38297,161328,1299,513,290545,1263526,46,77,166919,3616801,6858,19645,463517,822,1,75,1,4,509,0
Bacteroides_stercoris_56735,700024711,700172346,2743,2175905,327431,1419199,1061,476,29736,125153,1026,405,297695,1294046,35,71,170453,3704668,7017,15383,359446,630,4,67,0,3,402,0
Bacteroides_stercoris_56735,700024711,ERR912001,2370,2183407,328650,1424096,937,415,27080,114131,890,333,301570,1309965,47,82,172488,3750339,7068,13959,327819,615,5,77,0,4,329,0
Bacteroides_stercoris_56735,700024711,ERR912018,3009,2179402,328084,1421435,1188,559,34561,147087,1143,447,293523,1274348,45,112,167760,3648321,6963,18310,422231,720,4,107,1,3,444,0
Bacteroides_stercoris_56735,700024711,ERR912022,2981,2177001,327615,1419873,1194,530,34546,146964,1147,446,293069,1272909,47,84,167629,3644120,6978,18304,421871,717,3,81,0,2,444,0
Bacteroides_stercoris_56735,700024711,ERR912173,1566,2171080,326767,1415957,587,307,15612,65537,551,238,311155,1350420,36,69,177707,3866248,7305,7815,188442,354,5,64,0,1,237,0
Bacteroides_stercoris_56735,700032413,700037868,1032,2201637,331713,1436089,403,174,12293,54496,397,150,319420,1381593,6,24,180818,3956575,7386,7181,155977,330,1,23,0,0,150,0
Bacteroides_stercoris_56735,700033665,700117069,2016,2184068,329197,1424794,838,369,33569,140821,813,288,295628,1283973,25,81,169239,3675873,6807,17295,404451,717,6,75,0,0,288,0
Bacteroides_stercoris_56735,700033922,700035533,5930,2203377,331791,1437123,2448,963,90068,384825,2431,879,241723,1052298,17,84,139057,3012131,5706,49238,1103236,2001,0,84,0,2,876,1
Bacteroides_stercoris_56735,700033922,700097291,4083,2176661,327897,1419800,1664,741,61823,265076,1647,655,266074,1154724,17,86,152078,3306007,6087,33795,760074,1359,1,85,0,3,651,1
Bacteroides_stercoris_56735,700033922,700097906,2205,2217780,334136,1446617,881,410,31348,134005,861,339,302788,1312612,20,71,172494,3758271,7071,16939,384371,705,1,70,0,2,336,1
Bacteroides_stercoris_56735,700033922,700116730,2299,2209714,332878,1441315,926,429,32364,138188,903,358,300514,1303127,23,71,171369,3730983,7029,17408,396421,735,0,71,0,2,355,1
Bacteroides_stercoris_56735,700033922,700161533,2221,2212389,333213,1443110,879,423,31417,134297,863,348,301796,1308813,16,75,172050,3747351,7038,16961,385213,717,1,74,0,2,345,1
Bacteroides_stercoris_56735,700033922,700163628,3066,2204637,331787,1437940,1232,554,43126,184743,1217,480,288661,1253197,15,74,165188,3587575,6828,23365,529943,921,1,73,0,2,477,1
Bacteroides_stercoris_56735,700033922,ERR911990,2435,2197162,330868,1433061,974,467,37422,158926,949,399,293446,1274135,25,68,167862,3647640,6903,20046,455892,840,1,67,0,2,397,0
Bacteroides_stercoris_56735,700033922,ERR911993,2667,2198806,331159,1434108,1064,495,38030,161827,1045,430,293129,1272281,19,65,167512,3642428,6903,20496,464148,837,2,63,0,2,427,1
Bacteroides_stercoris_56735,700033922,ERR912165,2213,2212942,333318,1443454,879,418,31156,133293,860,345,302162,1310161,19,73,172203,3751200,7080,16873,382298,708,0,73,0,2,342,1
Bacteroides_stercoris_56735,700033922,SRR413601,2134,2186806,329395,1426223,837,407,31476,134645,825,331,297919,1291578,12,76,169975,3697796,6963,17046,386169,720,0,76,0,2,329,0
Bacteroides_stercoris_56735,700033922,SRR413607,2203,2216272,333890,1445655,873,411,31388,134230,857,339,302502,1311425,16,72,172341,3754893,7041,16950,385023,717,0,72,0,2,336,1
Bacteroides_stercoris_56735,700033922,SRR413618,2209,2217406,334070,1446386,874,418,31319,133892,856,344,302751,1312494,18,74,172484,3757945,7053,16920,384039,717,0,74,0,2,341,1
Bacteroides_stercoris_56735,700033922,SRR413619,2231,2217133,334014,1446220,881,422,31364,134079,861,347,302650,1312141,20,75,172440,3756918,7065,16953,384558,726,0,75,0,2,344,1
Bacteroides_stercoris_56735,700035157,1089275-24-28-0_,3135,2160184,325266,1408960,1256,530,43205,185405,1209,414,282061,1223555,47,116,160682,3503338,6645,23935,531314,966,4,111,1,1,413,0
Bacteroides_stercoris_56735,700035157,700037405,2453,2172195,327144,1416869,969,430,37382,160511,940,316,289762,1256358,29,114,164933,3597391,6750,20675,459964,894,4,109,1,1,315,0
Bacteroides_stercoris_56735,700035157,700095213,2494,2177042,327711,1419916,981,442,36674,157560,947,334,291037,1262356,34,108,165713,3614584,6771,20282,451522,876,6,102,0,0,334,0
Bacteroides_stercoris_56735,700035157,700095717,2466,2172616,327185,1417113,973,430,38015,163606,937,323,289170,1253507,36,107,164464,3589328,6729,21165,468726,927,4,102,1,0,323,0
Bacteroides_stercoris_56735,700035157,700096380,4053,2156356,324634,1406461,1600,711,57959,247647,1570,606,266675,1158814,30,105,152580,3317685,6177,31785,709812,1344,4,101,0,4,602,0
Bacteroides_stercoris_56735,700035157,700106325,2728,2163798,325832,1411193,1084,516,39035,167736,1045,408,286797,1243457,39,108,163228,3560462,6681,21575,480691,942,6,102,0,0,408,0
Bacteroides_stercoris_56735,700035157,700113810,2999,2161037,325517,1409478,1164,530,45792,197448,1118,408,279725,1212030,46,122,158955,3470628,6507,25565,565702,1077,3,119,0,1,407,0
Bacteroides_stercoris_56735,700035157,700114218,4051,2164619,325950,1411954,1656,684,57234,245164,1627,582,268716,1166790,29,102,153707,3340405,6258,31315,702869,1308,5,97,0,3,579,0
Bacteroides_stercoris_56735,700035157,700116865,6581,2172958,327287,1417316,2674,1131,100763,431913,2644,1022,226524,985403,30,109,130129,2820668,5412,55396,1238129,2214,3,106,0,5,1017,0
Bacteroides_stercoris_56735,700035157,700117303,2453,2157990,324905,1407486,968,423,36686,157710,930,319,288219,1249776,38,104,163833,3578775,6720,20321,451945,864,4,100,0,1,318,0
Bacteroides_stercoris_56735,700035157,700167825,2425,2152524,324148,1404139,967,414,37180,159946,933,315,286968,1244193,34,99,163249,3562688,6642,20663,458281,894,3,96,0,0,315,0
Bacteroides_stercoris_56735,700035157,700171679,4259,2180922,328420,1422464,1728,731,60038,256715,1690,623,268382,1165749,38,108,153624,3337338,6285,32632,736145,1368,3,104,1,2,621,0
Bacteroides_stercoris_56735,700035157,700172346,3512,2172200,326980,1416789,1391,613,48978,209450,1362,509,278002,1207339,29,104,158648,3456850,6519,26871,600396,1083,5,99,0,3,506,0
Bacteroides_stercoris_56735,700035157,ERR912001,3631,2179057,328105,1421279,1460,613,49313,210928,1412,491,278792,1210351,48,122,159190,3465329,6534,26899,604772,1113,6,116,0,2,489,0
Bacteroides_stercoris_56735,700035157,ERR912018,3679,2175706,327622,1419046,1471,674,53961,231574,1430,541,273661,1187472,41,133,156018,3399969,6429,29786,663712,1224,5,127,1,2,539,0
Bacteroides_stercoris_56735,700035157,ERR912022,3708,2172984,327121,1417261,1492,660,53794,230848,1449,551,273327,1186413,43,109,155933,3396874,6432,29668,661646,1230,4,105,0,1,550,0
Bacteroides_stercoris_56735,700035157,ERR912173,2518,2167752,326384,1413789,990,440,37755,162073,957,339,288629,1251716,33,101,164361,3584049,6738,20867,464455,897,6,95,0,0,339,0
Bacteroides_stercoris_56735,700035533,700097291,5326,2170141,326791,1415465,2199,878,81561,348794,2187,809,245230,1066671,12,69,140432,3053944,5637,44969,999631,1782,1,68,0,1,808,0
Bacteroides_stercoris_56735,700035533,700097906,4345,2205860,332175,1438757,1814,677,67423,287904,1804,617,264752,1150853,10,60,151726,3294632,6201,36793,825428,1491,1,59,0,0,617,0
Bacteroides_stercoris_56735,700035533,700116730,4436,2204682,331998,1437992,1855,705,66918,285446,1837,644,265080,1152546,18,61,152019,3299361,6258,36403,818483,1452,0,61,0,0,643,1
Bacteroides_stercoris_56735,700035533,700161533,4347,2201392,331383,1435842,1799,691,65699,280580,1786,624,265684,1155262,13,67,152337,3307194,6255,35857,804434,1449,1,66,0,0,624,0
Bacteroides_stercoris_56735,700035533,700163628,4281,2199540,330956,1434562,1770,659,69493,298474,1758,599,261463,1136088,12,60,149524,3252623,6117,38641,855194,1587,1,59,0,0,599,0
Bacteroides_stercoris_56735,700035533,ERR911990,6103,2189041,329527,1427670,2511,1025,90736,387559,2488,948,238791,1040111,23,77,137714,2976997,5622,49591,1111037,2049,1,76,0,3,945,0
Bacteroides_stercoris_56735,700035533,ERR911993,4478,2191915,330012,1429533,1837,714,68211,290935,1825,658,261801,1138598,12,56,150294,3259326,6174,37214,834076,1515,1,55,0,2,656,0
Bacteroides_stercoris_56735,700035533,ERR912165,4360,2205527,332089,1438523,1812,687,65959,281470,1798,628,266130,1157053,14,59,152549,3312352,6258,35983,806954,1473,0,59,0,1,627,0
Bacteroides_stercoris_56735,700035533,SRR413601,4276,2177316,327778,1420006,1781,682,65154,278074,1770,619,262624,1141932,11,63,150764,3268849,6183,35584,797207,1431,0,63,0,0,619,0
Bacteroides_stercoris_56735,700035533,SRR413607,4361,2204801,331982,1438104,1812,687,65900,281253,1799,617,266082,1156851,13,70,152514,3311799,6240,35925,806388,1446,0,70,0,0,617,0
Bacteroides_stercoris_56735,700035533,SRR413618,4345,2205652,332125,1438644,1809,687,65978,281613,1800,624,266147,1157031,9,63,152494,3312365,6234,36012,807363,1464,0,63,0,0,624,0
Bacteroides_stercoris_56735,700035533,SRR413619,4350,2205407,332071,1438477,1812,679,66476,283461,1798,626,265595,1155016,14,53,152308,3306494,6246,36198,812715,1470,0,53,0,0,625,1
Bacteroides_stercoris_56735,700037405,1089275-24-28-0_,1118,2177785,327904,1420436,404,248,12167,51080,360,137,315737,1369356,44,111,179748,3920883,7437,6381,146616,243,3,108,0,1,136,0
Bacteroides_stercoris_56735,700037405,700096380,2546,2171659,326955,1416466,963,489,31822,134158,932,382,295133,1282308,31,107,168872,3671212,6840,16766,384979,729,3,104,0,4,378,0
Bacteroides_stercoris_56735,700037405,700106325,1053,2172254,327118,1416809,402,248,10660,45083,366,151,316458,1371726,36,97,180161,3927625,7392,5424,129555,270,4,92,1,0,151,0
Bacteroides_stercoris_56735,700037405,700113810,1285,2169985,326890,1415417,465,269,15621,67368,419,155,311269,1348049,46,114,176797,3860057,7293,8565,193206,333,1,113,0,1,154,0
Bacteroides_stercoris_56735,700037405,700114218,2555,2181496,328448,1422998,1033,465,28088,118947,998,364,300360,1304051,35,101,171859,3733289,7005,14627,341596,618,5,95,1,2,362,0
Bacteroides_stercoris_56735,700037405,700116865,5621,2181341,328545,1422886,2256,974,85040,363725,2224,851,243505,1059161,32,123,139942,3031736,5805,46405,1042928,1842,2,120,1,5,846,0
Bacteroides_stercoris_56735,700037405,700171679,2671,2189456,329679,1428161,1075,485,29790,125901,1032,378,299889,1302260,43,107,171613,3728126,7041,15470,361585,648,2,105,0,2,376,0
Bacteroides_stercoris_56735,700037405,700172346,1882,2180759,328252,1422489,698,355,18839,79596,664,258,309413,1342893,34,97,176453,3844963,7263,9895,228512,381,4,93,0,2,256,0
Bacteroides_stercoris_56735,700037405,ERR912001,1484,2188688,329560,1427655,572,294,15175,64109,524,182,314385,1363546,48,112,178959,3904302,7377,8039,183970,318,6,106,0,1,181,0
Bacteroides_stercoris_56735,700037405,ERR912018,2016,2184584,328967,1424940,800,411,25239,107927,756,279,303728,1317013,44,132,172949,3770914,7176,13680,309576,525,5,127,0,1,278,0
Bacteroides_stercoris_56735,700037405,ERR912022,1995,2181928,328453,1423209,802,389,25764,110310,756,276,302689,1312899,46,113,172517,3759019,7161,13941,316449,540,3,109,1,1,275,0
Bacteroides_stercoris_56735,700037649,700038493,3681,2197213,331010,1433222,1478,640,47869,206978,1457,575,283141,1226244,21,65,161046,3511203,6483,26665,593186,1083,3,61,1,1,573,1
Bacteroides_stercoris_56735,700037649,700038870,3921,2159174,325127,1408140,1586,710,49696,214260,1561,631,275431,1193880,25,79,156902,3418426,6312,27876,613770,1134,1,78,0,2,628,1
Bacteroides_stercoris_56735,700037649,700098669,1703,2174716,327002,1418243,697,306,18115,77368,683,265,308887,1340875,14,41,176494,3839057,7074,9805,221888,411,1,39,1,1,264,0
Bacteroides_stercoris_56735,700037649,700105049,1148,2190963,329917,1429087,443,230,13089,56062,429,192,316828,1373025,14,38,179927,3931897,7251,7328,160555,303,1,35,2,1,191,0
Bacteroides_stercoris_56735,700037649,700111156,1542,2181681,328679,1423225,599,301,15894,67944,578,241,312785,1355281,21,60,177581,3881113,7149,8755,194705,372,1,57,2,2,239,0
Bacteroides_stercoris_56735,700037649,700164792,1846,2195222,330715,1431916,754,352,19743,84947,734,298,310972,1346969,20,54,176503,3857324,7080,11018,243385,438,2,51,1,1,297,0
Bacteroides_stercoris_56735,700037649,700172813,1838,2196733,330978,1432912,753,345,19921,85680,738,302,311057,1347232,15,43,176523,3858075,7098,11114,245482,444,0,42,1,1,301,0
Bacteroides_stercoris_56735,700037649,ERR911960,3922,2193228,330402,1430643,1582,708,49235,212365,1552,629,281167,1218278,30,79,159675,3488784,6375,27643,608321,1131,1,77,1,2,626,1
Bacteroides_stercoris_56735,700037649,ERR912198,1146,2192419,330302,1430062,438,229,12546,53887,424,188,317756,1376175,14,41,180185,3941101,7239,7050,154326,285,1,40,0,1,187,0
Bacteroides_stercoris_56735,700037649,SRR341646,1425,2136307,319520,1392658,565,257,17294,75060,556,225,302226,1317598,9,32,174500,3771193,7101,9878,214948,354,1,31,0,1,223,1
Bacteroides_stercoris_56735,700037649,SRR413558,1818,2194240,330564,1431326,743,343,19735,84949,729,295,310829,1346377,14,48,176369,3855688,7074,11025,243375,447,4,44,0,1,294,0
Bacteroides_stercoris_56735,700037649,SRR413594,2159,2194568,330632,1431536,860,374,27145,116705,845,341,303487,1314831,15,33,172340,3765226,6927,15122,334414,579,0,33,0,1,340,0
Bacteroides_stercoris_56735,700038493,700038870,4597,2160022,325221,1408693,1862,819,60917,262219,1832,719,264304,1146474,30,100,151093,3282233,6096,33739,751529,1389,3,97,0,2,715,2
Bacteroides_stercoris_56735,700038493,700098669,3255,2175537,327096,1418787,1323,550,42129,181288,1304,483,284967,1237499,19,67,163325,3542629,6543,23041,519860,963,2,65,0,1,481,1
Bacteroides_stercoris_56735,700038493,700105049,2977,2192148,330105,1429847,1191,511,39144,168953,1166,441,290961,1260894,25,70,165832,3610169,6681,21509,484447,903,4,65,1,0,440,1
Bacteroides_stercoris_56735,700038493,700111156,3010,2182373,328755,1423672,1202,534,37973,163946,1178,463,290782,1259726,24,71,165440,3607051,6687,20932,470045,861,1,69,1,1,461,1
Bacteroides_stercoris_56735,700038493,700164792,3264,2195536,330722,1432130,1326,567,42538,183687,1300,491,288184,1248443,26,76,163970,3574777,6582,23568,526521,972,4,72,0,1,489,1
Bacteroides_stercoris_56735,700038493,700172813,3255,2196860,330934,1432999,1321,562,42207,182466,1299,490,288727,1250533,22,72,164239,3580760,6600,23412,523020,966,3,67,2,0,489,1
Bacteroides_stercoris_56735,700038493,ERR911960,4652,2193807,330464,1431021,1885,825,61031,262569,1860,731,269433,1168452,25,94,153550,3345656,6150,33796,752522,1389,3,89,2,2,727,2
Bacteroides_stercoris_56735,700038493,ERR912198,3018,2193408,330443,1430708,1201,526,39157,168936,1181,451,291286,1261772,20,75,165798,3612867,6651,21490,484433,885,3,71,1,1,449,1
Bacteroides_stercoris_56735,700038493,SRR341646,3137,2136837,319593,1393012,1258,516,43207,187956,1239,448,276386,1205056,19,68,160108,3448550,6510,24298,538601,969,3,65,0,1,445,2
Bacteroides_stercoris_56735,700038493,SRR413558,3232,2194272,330556,1431358,1310,561,42133,182146,1285,480,288423,1249212,25,81,164000,3577084,6552,23380,522086,972,6,75,0,1,478,1
Bacteroides_stercoris_56735,700038493,SRR413594,3531,2194960,330673,1431797,1416,593,48419,209365,1399,531,282254,1222432,17,62,160697,3500188,6411,26787,600195,1113,3,59,0,0,530,1
Bacteroides_stercoris_56735,700038870,700098669,3218,2142877,322105,1397324,1325,568,44192,189942,1303,492,277913,1207382,22,76,159283,3456464,6399,24521,544312,993,2,74,0,1,490,1
Bacteroides_stercoris_56735,700038870,700105049,2997,2155206,324395,1405511,1218,557,40295,173820,1193,476,284100,1231691,25,81,161939,3526576,6558,22545,498012,903,2,78,1,1,474,1
Bacteroides_stercoris_56735,700038870,700111156,3133,2144599,322927,1398740,1252,580,40302,173858,1231,493,282625,1224882,21,87,160935,3507186,6525,22557,498111,906,2,84,1,2,490,1
Bacteroides_stercoris_56735,700038870,700164792,2488,2158931,325074,1407990,982,480,32767,140954,964,409,292307,1267036,18,71,166460,3627937,6711,18291,403839,732,2,69,0,2,406,1
Bacteroides_stercoris_56735,700038870,700172813,2479,2159485,325158,1408355,977,474,32787,141013,962,407,292371,1267342,15,67,166501,3628808,6717,18298,404006,735,1,65,1,1,405,1
Bacteroides_stercoris_56735,700038870,ERR911960,129,2158568,325010,1407758,50,44,802,3359,32,16,324208,1404399,18,28,184264,4021457,7476,421,9653,3,2,25,1,0,16,0
Bacteroides_stercoris_56735,700038870,ERR912198,3023,2155894,324652,1406004,1224,567,40772,175741,1205,489,283880,1230263,19,78,161659,3522614,6516,22767,503547,909,1,77,0,1,487,1
Bacteroides_stercoris_56735,700038870,SRR341646,3142,2103230,314491,1370886,1265,554,42882,185932,1247,482,271609,1184954,18,72,157428,3390999,6435,24317,532546,933,2,70,0,1,481,0
Bacteroides_stercoris_56735,700038870,SRR413558,2511,2158359,325016,1407646,986,487,32731,140771,966,414,292285,1266875,20,73,166403,3627520,6702,18236,403345,732,5,68,0,1,412,1
Bacteroides_stercoris_56735,700038870,SRR413594,3813,2158041,324979,1407450,1559,677,52354,225955,1544,608,272625,1181495,15,69,155314,3382901,6270,29315,647407,1143,1,68,0,1,606,1
Bacteroides_stercoris_56735,700095213,1089275-24-28-0_,1097,2189851,329672,1428377,403,235,10611,44971,354,133,319061,1383406,49,102,181627,3961091,7500,5642,129073,198,3,98,1,2,131,0
Bacteroides_stercoris_56735,700095213,700096380,2510,2185866,329055,1425779,959,474,31770,134009,926,383,297285,1291770,33,91,170206,3698234,6870,16758,384537,732,2,89,0,6,377,0
Bacteroides_stercoris_56735,700095213,700106325,1030,2182593,328556,1423450,401,235,11116,47313,366,152,317440,1376137,35,83,180678,3940329,7404,5746,135920,273,6,77,0,0,152,0
Bacteroides_stercoris_56735,700095213,700113810,1259,2190631,329930,1428861,461,257,15632,67433,416,153,314298,1361428,45,104,178556,3898405,7323,8583,193383,333,2,102,0,2,151,0
Bacteroides_stercoris_56735,700095213,700114218,2531,2183655,328682,1424380,1029,450,28392,120357,996,361,300290,1304023,33,89,171886,3733187,6996,14826,345615,630,6,83,0,2,359,0
Bacteroides_stercoris_56735,700095213,700116865,5671,2202066,331574,1436376,2278,979,86463,370567,2248,866,245111,1065809,30,113,140837,3050761,5829,47307,1062519,1875,3,110,0,5,861,0
Bacteroides_stercoris_56735,700095213,700171679,2744,2209563,332629,1441237,1103,497,31256,132350,1061,396,301373,1308887,42,101,172584,3747030,7047,16250,380119,681,3,97,1,2,394,0
Bacteroides_stercoris_56735,700095213,700172346,1847,2189771,329485,1428255,692,337,18772,79386,656,252,310713,1348869,36,85,177217,3862106,7284,9868,227909,381,5,80,0,3,249,0
Bacteroides_stercoris_56735,700095213,ERR912001,1450,2209500,332638,1441191,563,282,15119,63930,518,185,317519,1377261,45,97,180793,3943580,7410,8012,183460,318,7,90,0,1,184,0
Bacteroides_stercoris_56735,700095213,ERR912018,2001,2205007,331964,1438218,796,405,25232,107936,751,280,306732,1330282,45,125,174697,3808943,7206,13694,309586,528,5,119,1,2,278,0
Bacteroides_stercoris_56735,700095213,ERR912022,1970,2203017,331570,1436928,798,375,25220,107830,751,276,306350,1329098,47,99,174599,3805468,7227,13679,309292,519,3,96,0,2,274,0
Bacteroides_stercoris_56735,700095717,1089275-24-28-0_,1101,2190494,329907,1428806,404,234,10651,45130,355,135,319256,1383676,49,99,181594,3961910,7524,5666,129526,198,1,98,0,2,133,0
Bacteroides_stercoris_56735,700095717,700096380,2534,2185704,329122,1425703,966,475,32649,137647,938,387,296473,1288056,28,88,169710,3687618,6840,17229,394953,759,1,87,0,5,382,0
Bacteroides_stercoris_56735,700095717,700106325,1040,2178868,328088,1421082,402,237,11140,47398,368,152,316948,1373684,34,85,180428,3933208,7416,5751,136176,267,4,80,1,0,152,0
Bacteroides_stercoris_56735,700095717,700113810,1266,2185405,329276,1425507,464,254,15670,67558,417,151,313606,1357949,47,103,178123,3888395,7329,8597,193750,327,0,103,0,2,149,0
Bacteroides_stercoris_56735,700095717,700114218,2540,2184407,328948,1424881,1034,448,28385,120315,999,363,300563,1304566,35,85,171891,3734793,7014,14827,345485,633,4,80,1,2,361,0
Bacteroides_stercoris_56735,700095717,700116865,5644,2197395,331018,1433372,2270,976,88005,376941,2242,868,243013,1056431,28,108,139602,3023886,5805,48153,1080765,1905,1,106,1,5,863,0
Bacteroides_stercoris_56735,700095717,700171679,2687,2204724,332029,1438155,1084,483,29934,126766,1033,386,302095,1311389,51,97,172827,3754260,7080,15617,364024,657,1,96,0,2,384,0
Bacteroides_stercoris_56735,700095717,700172346,1873,2184683,328841,1425014,699,343,18849,79659,664,256,309992,1345355,35,87,176772,3852006,7287,9897,228693,387,2,85,0,3,253,0
Bacteroides_stercoris_56735,700095717,ERR912001,1439,2204272,331990,1437849,557,277,14885,62883,515,182,317105,1374966,42,95,180517,3936950,7431,7860,180477,312,5,90,0,1,181,0
Bacteroides_stercoris_56735,700095717,ERR912018,1993,2200105,331359,1435086,793,401,25218,107846,750,278,306141,1327240,43,123,174305,3800182,7233,13687,309332,519,3,120,0,2,276,0
Bacteroides_stercoris_56735,700095717,ERR912022,1968,2197479,330852,1433373,794,377,25217,107761,749,273,305635,1325612,45,104,174165,3795432,7239,13675,309095,513,1,102,1,2,271,0
Bacteroides_stercoris_56735,700096380,1089275-24-28-0_,2191,2174730,327404,1418466,820,441,29935,125571,780,339,297469,1292895,40,102,170336,3701482,6867,15688,360311,714,2,100,0,3,336,0
Bacteroides_stercoris_56735,700096380,700106325,2949,2167872,326420,1413908,1151,552,36071,152083,1119,461,290349,1261825,32,91,166301,3612457,6717,18987,436416,846,3,88,0,5,456,0
Bacteroides_stercoris_56735,700096380,700113810,2475,2174204,327503,1418174,943,472,32908,139318,902,359,294595,1278856,41,113,168355,3661424,6789,17519,399667,768,1,112,0,3,356,0
Bacteroides_stercoris_56735,700096380,700114218,4042,2170034,326658,1415412,1615,723,50686,214744,1584,628,275972,1200668,31,95,158730,3436884,6390,26852,616240,1140,4,91,0,6,622,0
Bacteroides_stercoris_56735,700096380,700117303,2532,2150458,323650,1402576,967,476,31590,133326,926,388,292060,1269250,41,88,167026,3633938,6786,16663,382595,720,3,85,0,4,384,0
Bacteroides_stercoris_56735,700096380,700167825,2498,2169322,326636,1415119,952,470,31607,133408,911,376,295029,1281711,41,94,168828,3669510,6795,16653,382842,729,1,93,0,4,372,0
Bacteroides_stercoris_56735,700096380,700171679,4161,2187934,329428,1427155,1656,746,51955,219904,1617,642,277473,1207251,39,104,159646,3455672,6435,27467,631087,1158,1,103,0,6,636,0
Bacteroides_stercoris_56735,700096380,700172346,1704,2168492,326368,1414380,634,359,23933,101098,611,285,302435,1313282,23,74,172700,3760162,6984,12687,290037,570,3,71,0,2,283,0
Bacteroides_stercoris_56735,700096380,ERR912001,3753,2186351,329162,1426141,1476,649,46538,196643,1431,541,282624,1229498,45,108,162349,3519557,6588,24613,564308,1008,5,103,0,5,536,0
Bacteroides_stercoris_56735,700096380,ERR912018,2837,2185907,329135,1425803,1101,541,39611,167692,1066,417,289524,1258111,35,124,165814,3601799,6720,21091,481100,885,3,121,0,4,413,0
Bacteroides_stercoris_56735,700096380,ERR912022,2801,2180593,328223,1422350,1098,512,39520,167448,1062,412,288703,1254902,36,100,165415,3592571,6720,21076,480380,888,2,98,0,3,409,0
Bacteroides_stercoris_56735,700096380,ERR912173,2540,2174023,327278,1417982,967,476,32766,138068,939,385,294512,1279914,28,91,168764,3664168,6810,17273,396166,765,4,87,0,4,381,0
Bacteroides_stercoris_56735,700097291,700097906,2168,2179440,328321,1421624,896,405,34930,150062,882,354,293391,1271562,14,51,166748,3641260,6678,19368,430059,759,2,49,0,1,353,0
Bacteroides_stercoris_56735,700097291,700116730,2277,2176549,327904,1419711,941,430,35240,151210,922,368,292664,1268501,19,62,166427,3632386,6690,19432,433433,765,1,61,0,1,367,0
Bacteroides_stercoris_56735,700097291,700161533,2189,2176079,327710,1419454,891,421,34761,149350,878,360,292949,1270104,13,61,166620,3637017,6675,19253,428026,771,2,59,0,1,359,0
Bacteroides_stercoris_56735,700097291,700163628,2572,2171513,326847,1416340,1056,470,39717,170996,1042,414,287130,1245344,14,56,163409,3566029,6594,22224,489915,849,2,54,0,1,413,0
Bacteroides_stercoris_56735,700097291,ERR911990,4625,2162982,325718,1410786,1856,861,66915,286543,1826,778,258803,1124243,30,83,148381,3218423,5925,36550,821591,1488,2,81,0,3,775,0
Bacteroides_stercoris_56735,700097291,ERR911993,2513,2165822,326186,1412624,1031,475,39986,171169,1018,421,286200,1241455,13,54,163032,3554784,6549,22094,490540,873,1,53,0,2,419,0
Bacteroides_stercoris_56735,700097291,ERR912165,2185,2179448,328287,1421626,900,412,34306,147415,881,359,293981,1274211,19,53,167092,3648818,6723,19039,422462,744,1,52,0,1,358,0
Bacteroides_stercoris_56735,700097291,SRR413601,2139,2151790,324065,1403428,865,414,34304,147436,855,352,289761,1255992,10,62,164923,3596444,6609,19086,422460,762,1,61,0,1,351,0
Bacteroides_stercoris_56735,700097291,SRR413607,2177,2178503,328161,1421049,891,414,34963,150182,880,354,293198,1270867,11,60,166615,3639320,6666,19401,430374,771,1,59,0,1,353,0
Bacteroides_stercoris_56735,700097291,SRR413618,2176,2179396,328295,1421629,895,413,34536,148372,878,356,293759,1273257,17,57,166925,3646147,6699,19168,425195,753,1,56,0,1,355,0
Bacteroides_stercoris_56735,700097291,SRR413619,2187,2179029,328236,1421388,899,417,34792,149446,881,355,293444,1271942,18,62,166799,3642334,6693,19287,428277,774,1,61,0,1,354,0
Bacteroides_stercoris_56735,700097688,700117537,2839,2157309,324922,1407271,1143,539,43499,185577,1099,418,281423,1221694,44,121,160481,3498010,6591,23896,531932,903,2,119,0,2,416,0
Bacteroides_stercoris_56735,700097688,SRR341618,121,2128895,320193,1388533,19,75,78,333,1,0,320115,1388200,18,75,182174,3974992,7434,41,958,0,1,74,0,0,0,0
Bacteroides_stercoris_56735,700097688,SRR341624,2970,2126014,319220,1386027,1220,538,47635,203767,1171,408,271585,1182260,49,130,156668,3383719,6393,26105,584128,1068,4,125,1,2,406,0
Bacteroides_stercoris_56735,700097688,SRR341640,5744,2075113,312119,1353334,2405,998,80990,343769,2361,865,231129,1009565,44,133,133926,2889297,5472,43762,985790,1755,2,131,0,2,863,0
Bacteroides_stercoris_56735,700097688,SRR341645,130,2090063,313203,1361952,22,79,78,339,1,0,313125,1361613,21,79,180366,3897105,7368,46,971,0,2,77,0,0,0,0
Bacteroides_stercoris_56735,700097688,SRR341710,134,2133762,321102,1391793,25,83,88,392,1,0,321014,1391401,24,83,182567,3984232,7404,52,1124,0,1,82,0,0,0,0
Bacteroides_stercoris_56735,700097688,SRR413559,2091,2144640,323107,1399041,842,427,34534,147652,791,289,288573,1251389,51,138,164243,3583261,6663,18903,423333,720,3,134,1,3,286,0
Bacteroides_stercoris_56735,700097688,SRR413580,6423,2146370,323285,1400171,2683,1102,88362,374987,2642,975,234923,1025184,41,127,135743,2934298,5511,47765,1075333,1863,1,126,0,4,971,0
Bacteroides_stercoris_56735,700097688,SRR413627,6492,2155461,324739,1406098,2700,1117,89128,377819,2658,974,235611,1028279,42,143,136124,2943181,5532,48049,1083518,1890,2,141,0,3,971,0
Bacteroides_stercoris_56735,700097688,SRR413663,6265,2147748,323577,1401182,2634,1079,86102,365101,2591,952,237475,1036081,43,127,137161,2965538,5544,46356,1047123,1824,2,125,0,4,948,0
Bacteroides_stercoris_56735,700097906,700116730,162,2212411,333290,1443087,60,53,954,3962,40,12,332336,1439125,20,41,188586,4121055,7734,435,11436,15,1,40,0,0,12,0
Bacteroides_stercoris_56735,700097906,700163628,955,2207093,332148,1439561,389,176,13129,56148,374,139,319019,1383413,15,37,181791,3960945,7503,6995,161218,231,2,35,0,0,139,0
Bacteroides_stercoris_56735,700097906,ERR911990,2594,2198959,331140,1434241,1020,493,35660,151744,995,424,295480,1282497,25,69,169049,3671536,6906,19032,435366,834,2,67,0,2,422,0
Bacteroides_stercoris_56735,700097906,ERR911993,534,2201413,331553,1435819,209,113,6891,28880,193,76,324662,1406939,16,37,184541,4028653,7623,3692,82834,114,3,34,0,0,76,0
Bacteroides_stercoris_56735,700098669,700105049,775,2171522,326418,1416125,330,144,7502,31527,311,101,318916,1384598,19,43,182283,3964194,7317,3772,90614,195,2,40,1,0,101,0
Bacteroides_stercoris_56735,700098669,700111156,987,2160468,324852,1409076,396,169,9716,40781,377,118,315136,1368295,19,51,180153,3917496,7236,4866,117246,231,2,48,1,1,117,0
Bacteroides_stercoris_56735,700098669,700164792,1150,2173900,326865,1417710,496,212,13552,57360,477,158,313313,1360350,19,54,179055,3894822,7173,7172,164608,300,3,51,0,0,158,0
Bacteroides_stercoris_56735,700098669,700172813,1151,2174821,327016,1418337,498,210,13565,57415,482,161,313451,1360922,16,49,179103,3896475,7188,7189,164759,297,1,46,2,0,161,0
Bacteroides_stercoris_56735,700098669,ERR911960,3238,2173667,326839,1417587,1332,567,43758,187966,1305,489,283081,1229621,27,78,161942,3520456,6465,24223,538694,981,2,74,2,1,487,1
Bacteroides_stercoris_56735,700098669,ERR912198,799,2172995,326756,1417130,334,155,7652,32180,318,110,319104,1384950,16,45,182239,3965321,7290,3851,92494,195,1,43,1,1,109,0
Bacteroides_stercoris_56735,700098669,SRR341646,1079,2126891,317893,1386404,457,186,12994,55799,446,152,304899,1330605,11,34,176703,3807966,7146,7014,160110,273,1,33,0,1,150,1
Bacteroides_stercoris_56735,700098669,SRR413558,1147,2173939,326869,1417795,495,209,13685,57894,480,158,313184,1359901,15,51,178949,3893608,7146,7237,166139,306,5,46,0,0,158,0
Bacteroides_stercoris_56735,700098669,SRR413594,1762,2174815,327038,1418384,730,287,21622,92668,717,252,305416,1325716,13,35,174621,3795537,6990,11634,265905,465,1,34,0,0,252,0
Bacteroides_stercoris_56735,700099886,700105882,2117,2187522,329282,1427012,824,373,23700,102000,789,287,305582,1325012,35,86,173806,3794291,6939,13125,292416,459,4,82,0,0,287,0
Bacteroides_stercoris_56735,700102043,700116505,488,2167706,326682,1413896,179,125,5181,21385,154,56,321501,1392511,25,69,182588,3987757,7188,2488,61535,132,0,68,1,0,56,0
Bacteroides_stercoris_56735,700105049,700111156,607,2176083,327663,1419504,220,146,5068,21021,200,84,322595,1398483,20,62,183446,4004584,7419,2494,60446,123,2,60,0,1,83,0
Bacteroides_stercoris_56735,700105049,700164792,999,2189364,329643,1428049,407,220,10230,43598,387,161,319413,1384451,20,59,181603,3964451,7299,5510,125044,240,3,55,1,0,161,0
Bacteroides_stercoris_56735,700105049,700172813,993,2190353,329815,1428710,408,214,10283,43779,391,161,319532,1384931,17,53,181662,3965832,7299,5534,125566,237,1,51,1,0,161,0
Bacteroides_stercoris_56735,700105049,ERR911960,2989,2187325,329353,1426736,1213,556,39655,171085,1183,475,289698,1255651,30,81,164683,3595640,6630,22205,490153,897,2,78,1,1,473,1
Bacteroides_stercoris_56735,700105049,SRR341646,410,2132364,318867,1390033,173,86,5674,24772,160,52,313193,1365261,13,34,180832,3907559,7392,3244,70991,81,2,31,1,0,51,1
Bacteroides_stercoris_56735,700105049,SRR413558,988,2188177,329489,1427318,400,217,10402,44271,384,161,319087,1383047,16,56,181364,3960508,7269,5598,126969,246,5,50,1,0,161,0
Bacteroides_stercoris_56735,700105049,SRR413594,1075,2188943,329624,1427822,436,185,14213,61461,420,156,315411,1366361,16,29,179144,3912688,7251,7917,176190,276,0,28,1,1,155,0
Bacteroides_stercoris_56735,700106170,pluto3-11-0-0_,2610,2108192,317069,1374863,1053,509,37424,157557,997,374,279645,1217306,56,135,161207,3484198,6513,19454,452452,765,1,134,0,0,373,1
Bacteroides_stercoris_56735,700106229,700116028,1559,2214202,333490,1444317,631,320,23229,99195,613,257,310261,1345122,18,63,176575,3851480,7311,12542,284533,510,1,62,0,1,255,1
Bacteroides_stercoris_56735,700106325,1089275-24-28-0_,1721,2164834,325947,1411897,685,351,18565,78587,637,251,307382,1333310,48,100,175255,3817436,7239,9756,225606,399,4,95,1,1,250,0
Bacteroides_stercoris_56735,700106325,700113810,1766,2179369,328236,1421425,695,353,20640,88713,645,247,307596,1332712,50,106,174901,3816053,7182,11162,254506,471,3,103,0,1,246,0
Bacteroides_stercoris_56735,700106325,700114218,2618,2169477,326640,1415032,1102,477,30030,126733,1065,389,296610,1288299,37,88,169898,3688075,6924,15548,363979,672,5,83,0,3,386,0
Bacteroides_stercoris_56735,700106325,700116865,6154,2177151,327874,1419964,2498,1072,89247,381660,2465,957,238627,1038304,33,115,137404,2971823,5685,48500,1094521,1959,4,111,0,4,953,0
Bacteroides_stercoris_56735,700106325,700117303,1049,2158108,324884,1407476,409,235,10624,44974,366,153,314260,1362502,43,82,178725,3901458,7323,5406,129246,270,5,77,0,0,153,0
Bacteroides_stercoris_56735,700106325,700167825,1034,2158285,325010,1407829,406,237,10631,45043,367,154,314379,1362786,39,83,178962,3902085,7311,5418,129453,258,3,80,0,0,154,0
Bacteroides_stercoris_56735,700106325,700171679,2834,2185689,329110,1425496,1180,523,33516,141586,1137,429,295594,1283910,43,94,169300,3675476,6954,17363,406669,726,3,90,1,2,427,0
Bacteroides_stercoris_56735,700106325,700172346,2205,2176284,327598,1419365,879,407,23084,97442,841,317,304514,1321923,38,90,173794,3784844,7131,12057,279777,492,6,84,0,2,315,0
Bacteroides_stercoris_56735,700106325,ERR912001,2202,2184338,328881,1424638,870,413,23831,101058,828,315,305050,1323580,42,98,174062,3789532,7146,12474,290166,534,7,91,0,1,314,0
Bacteroides_stercoris_56735,700106325,ERR912018,2397,2183979,328822,1424353,948,482,29696,127107,906,359,299126,1297246,42,123,170501,3714181,7056,16031,364657,633,5,117,1,2,357,0
Bacteroides_stercoris_56735,700106325,ERR912022,2367,2179124,328005,1421195,950,453,29684,127074,906,353,298321,1294121,44,100,170101,3705209,7053,16040,364552,630,4,96,0,1,352,0
Bacteroides_stercoris_56735,700106325,ERR912173,1042,2172102,326991,1416540,405,235,10655,45094,367,151,316336,1371446,38,84,180195,3926748,7395,5422,129590,270,6,78,0,0,151,0
Bacteroides_stercoris_56735,700108161,700166862,723,2199156,331408,1434491,267,173,7707,32627,242,117,323701,1401864,25,56,183946,4014209,7437,3872,93838,171,1,55,0,0,117,0
Bacteroides_stercoris_56735,700108161,SRR413621,240,2203049,331957,1437043,77,74,1996,8754,60,27,329961,1428289,17,47,187114,4090211,7542,1050,25152,60,1,46,0,0,27,0
Bacteroides_stercoris_56735,700111156,700164792,903,2180291,328437,1422308,359,187,9139,39227,341,129,319298,1383081,18,58,181185,3960750,7308,4999,112472,210,3,54,1,1,128,0
Bacteroides_stercoris_56735,700111156,700172813,906,2181255,328601,1422950,363,184,8906,38151,345,129,319695,1384799,18,55,181406,3965668,7323,4862,109390,201,1,53,1,1,128,0
Bacteroides_stercoris_56735,700111156,ERR911960,3116,2181659,328668,1423254,1245,573,39586,170619,1220,492,289082,1252635,25,81,164088,3587226,6591,22147,488807,903,1,79,1,3,488,1
Bacteroides_stercoris_56735,700111156,ERR912198,630,2180366,328489,1422334,222,156,5127,21275,204,88,323362,1401059,18,68,183628,4012169,7380,2519,61183,123,2,64,2,1,87,0
Bacteroides_stercoris_56735,700111156,SRR341646,930,2127182,318188,1386872,369,184,11514,49358,355,137,306674,1337514,14,47,177239,3828094,7209,6240,141606,228,1,45,1,2,134,1
Bacteroides_stercoris_56735,700111156,SRR413558,902,2185727,329330,1425937,357,189,8845,37880,337,127,320485,1388057,20,62,181729,3975155,7287,4826,108604,210,5,56,1,1,126,0
Bacteroides_stercoris_56735,700111156,SRR413594,1589,2185795,329352,1425995,626,291,18755,80074,610,236,310597,1345921,16,55,176493,3854169,7101,10106,229723,393,1,53,1,1,235,0
Bacteroides_stercoris_56735,700113810,1089275-24-28-0_,1034,2174149,327514,1418152,383,227,11440,49530,329,119,316074,1368622,54,108,179527,3918956,7383,6300,142047,243,1,107,0,0,119,0
Bacteroides_stercoris_56735,700113810,700114218,3124,2168408,326594,1414451,1266,533,36923,157642,1218,429,289671,1256809,48,104,165592,3598061,6774,19725,452406,795,3,101,0,3,426,0
Bacteroides_stercoris_56735,700113810,700117303,1261,2157050,324829,1406875,461,253,15562,67274,408,154,309267,1339601,53,99,175430,3836143,7230,8565,192924,333,2,97,0,1,153,0
Bacteroides_stercoris_56735,700113810,700167825,1261,2168293,326677,1414523,463,256,15504,66956,414,149,311173,1347567,49,107,176754,3858699,7248,8508,192039,321,0,107,0,1,148,0
Bacteroides_stercoris_56735,700113810,700171679,3339,2194078,330530,1431131,1344,581,39577,168740,1283,467,290953,1262391,61,114,166365,3613974,6834,21033,484353,834,0,114,0,3,464,0
Bacteroides_stercoris_56735,700113810,700172346,1705,2174643,327431,1418416,635,336,18357,78452,592,230,309074,1339964,43,106,175868,3836821,7203,9809,225160,387,3,103,0,1,229,0
Bacteroides_stercoris_56735,700113810,ERR912001,2546,2194103,330526,1431181,990,446,31889,136345,933,333,298637,1294836,57,113,170143,3707372,6993,17217,391137,681,4,109,0,2,331,0
Bacteroides_stercoris_56735,700113810,ERR912018,1953,2192727,330292,1430257,771,392,27451,118455,723,263,302841,1311802,48,129,172235,3756085,7086,15049,339722,594,2,127,0,1,262,0
Bacteroides_stercoris_56735,700113810,ERR912022,1953,2187516,329454,1426848,785,372,27525,118697,736,262,301929,1308151,49,110,171758,3745609,7086,15082,340427,582,1,109,0,0,262,0
Bacteroides_stercoris_56735,700113810,ERR912173,1278,2182057,328666,1423215,467,255,15668,67611,419,150,312998,1355604,48,105,177856,3881633,7323,8604,193896,333,3,102,0,1,149,0
Bacteroides_stercoris_56735,700114218,1089275-24-28-0_,3261,2178508,327944,1420979,1320,556,36627,154669,1276,452,291317,1266310,44,104,167088,3624987,6855,19185,444063,759,4,99,1,3,449,0
Bacteroides_stercoris_56735,700114218,700116865,6988,2178923,328111,1421351,2841,1184,96743,413321,2809,1072,231368,1008030,32,112,133791,2884773,5526,52445,1185439,2079,4,108,0,4,1068,0
Bacteroides_stercoris_56735,700114218,700117303,2502,2165174,325892,1412334,1015,439,28178,119738,976,353,297714,1292596,39,86,170189,3700654,6945,14736,343857,621,4,82,0,3,350,0
Bacteroides_stercoris_56735,700114218,700167825,2533,2170241,326745,1415760,1035,450,27898,118027,996,360,298847,1297733,39,90,170994,3715254,6951,14508,338958,615,3,87,0,2,358,0
Bacteroides_stercoris_56735,700114218,700171679,187,2188587,329553,1427608,57,66,1494,6162,32,7,328059,1421446,25,59,186330,4070343,7665,754,17717,15,3,55,1,0,7,0
Bacteroides_stercoris_56735,700114218,700172346,3268,2178673,327908,1421164,1341,551,37538,159445,1304,459,290370,1261719,37,92,166415,3611947,6795,19862,457669,804,4,88,0,4,455,0
Bacteroides_stercoris_56735,700114218,ERR912001,3714,2187448,329329,1426904,1510,624,41180,174722,1466,527,288149,1252182,44,97,165289,3584525,6732,21687,501570,909,5,92,0,5,522,0
Bacteroides_stercoris_56735,700114218,ERR912018,3817,2184474,328929,1424912,1570,656,45230,192534,1529,534,283699,1232378,41,122,162553,3527891,6690,24127,552518,957,3,118,1,6,528,0
Bacteroides_stercoris_56735,700114218,ERR912022,3870,2181776,328403,1423176,1601,649,45478,193495,1557,548,282925,1229681,44,101,162259,3520082,6702,24269,555262,954,3,98,0,3,545,0
Bacteroides_stercoris_56735,700114218,ERR912173,2456,2178613,327949,1421067,990,443,27438,116232,953,357,300511,1304835,37,86,172007,3735493,7005,14334,333744,618,6,80,0,2,355,0
Bacteroides_stercoris_56735,700116730,700161533,171,2207617,332479,1439945,58,63,954,3962,40,12,331525,1435983,18,51,188197,4112018,7734,435,11436,15,1,50,0,0,12,0
Bacteroides_stercoris_56735,700116730,700163628,1072,2205759,331981,1438692,433,207,14485,61816,416,152,317496,1376876,17,55,180961,3942200,7467,7665,177504,279,1,53,1,0,152,0
Bacteroides_stercoris_56735,700116730,ERR911990,2687,2195403,330616,1431887,1065,515,36708,156074,1040,446,293908,1275813,25,69,168217,3652349,6873,19534,447839,849,1,68,0,2,444,0
Bacteroides_stercoris_56735,700116730,ERR911993,638,2198489,331136,1433884,254,132,7863,32911,233,91,323273,1400973,21,41,183816,4011489,7614,4138,94469,126,2,39,0,0,91,0
Bacteroides_stercoris_56735,700116730,ERR912165,169,2212336,333263,1443037,64,52,1272,5270,44,14,331991,1437767,20,38,188446,4117106,7749,578,15205,27,0,38,0,0,14,0
Bacteroides_stercoris_56735,700116730,SRR413601,167,2183553,328869,1424108,55,62,954,3959,40,12,327915,1420149,15,50,186369,4066422,7656,435,11427,15,0,50,0,0,12,0
Bacteroides_stercoris_56735,700116730,SRR413607,168,2211136,333081,1442280,55,56,954,3943,40,12,332127,1438337,15,44,188463,4118802,7746,433,11384,12,0,44,0,0,12,0
Bacteroides_stercoris_56735,700116730,SRR413618,160,2212183,333243,1442963,60,50,963,4004,40,12,332280,1438959,20,38,188549,4120585,7743,444,11553,15,0,38,0,0,12,0
Bacteroides_stercoris_56735,700116730,SRR413619,174,2211868,333185,1442757,64,55,954,3959,40,12,332231,1438798,24,43,188547,4120074,7773,435,11427,15,0,43,0,0,12,0
Bacteroides_stercoris_56735,700116865,1089275-24-28-0_,6009,2184274,328975,1424800,2418,1036,90781,388726,2369,914,238194,1036074,49,122,136944,2965548,5730,49774,1114466,1938,2,119,1,5,909,0
Bacteroides_stercoris_56735,700116865,700117303,5686,2167242,326322,1413569,2291,974,85585,366415,2259,864,240737,1047154,32,110,138241,2997470,5751,46660,1050752,1833,2,108,0,5,859,0
Bacteroides_stercoris_56735,700116865,700167825,5563,2179082,328262,1421588,2243,953,89382,383394,2209,842,238880,1038194,34,111,136869,2972070,5643,49345,1098884,1953,1,110,0,4,838,0
Bacteroides_stercoris_56735,700116865,700172346,6396,2185142,328949,1425293,2584,1086,92654,396415,2547,974,236295,1028878,37,112,136244,2944720,5670,50356,1136915,1974,2,110,0,8,966,0
Bacteroides_stercoris_56735,700116865,ERR912001,6503,2204439,332044,1437964,2616,1118,96365,412956,2566,993,235679,1025008,50,125,135406,2934011,5607,52857,1183908,2103,4,121,0,6,987,0
Bacteroides_stercoris_56735,700116865,ERR912173,5733,2192292,330166,1429942,2303,992,88089,377479,2268,883,242077,1052463,35,109,139162,3012428,5799,48201,1082352,1884,4,105,0,4,879,0
Bacteroides_stercoris_56735,700117303,1089275-24-28-0_,1111,2160625,325228,1409222,410,234,12169,51146,357,137,313059,1358076,53,97,178105,3888770,7353,6396,146799,243,3,94,0,1,136,0
Bacteroides_stercoris_56735,700117303,700171679,2694,2174977,327399,1418602,1084,479,30935,131227,1037,387,296464,1287375,47,92,169536,3685632,6957,16071,376947,663,1,91,0,3,384,0
Bacteroides_stercoris_56735,700117303,700172346,1871,2168468,326305,1414380,700,343,20656,87597,666,260,305649,1326783,34,83,174067,3799115,7167,10974,251391,426,5,78,0,2,258,0
Bacteroides_stercoris_56735,700117303,ERR912001,1470,2177760,327829,1420420,575,280,15219,64314,523,184,312610,1356106,52,96,177751,3883247,7320,8049,184575,318,6,90,0,1,183,0
Bacteroides_stercoris_56735,700117303,ERR912018,2032,2173243,327160,1417427,807,407,25301,108298,755,283,301859,1309129,52,124,171679,3748592,7116,13708,310661,525,4,120,0,2,281,0
Bacteroides_stercoris_56735,700117303,ERR912022,2000,2170436,326630,1415632,809,376,25322,108351,755,280,301308,1307281,54,96,171488,3743227,7128,13727,310807,519,2,94,0,2,278,0
Bacteroides_stercoris_56735,700117537,SRR341618,2781,2167237,325758,1413581,1122,527,43195,184656,1086,411,282563,1228925,36,116,161741,3518392,6642,23856,529173,939,4,112,0,2,409,0
Bacteroides_stercoris_56735,700117537,SRR341624,2787,2175081,326371,1417928,1131,505,32692,138323,1083,375,293679,1279605,48,130,169442,3662428,6945,17555,396703,711,5,124,1,1,374,0
Bacteroides_stercoris_56735,700117537,SRR341640,5489,2109204,317082,1375584,2334,924,67057,284353,2286,791,250025,1091231,48,133,144466,3123311,5916,36192,815394,1473,3,130,0,0,791,0
Bacteroides_stercoris_56735,700117537,SRR341645,2659,2127137,318563,1386113,1054,516,41347,177243,1014,392,277216,1208870,40,124,160542,3459492,6576,23185,507608,936,5,119,0,2,390,0
Bacteroides_stercoris_56735,700117537,SRR341710,2865,2172135,326704,1416821,1160,548,43573,186108,1118,424,283131,1230713,42,124,161992,3523538,6609,24000,533385,939,4,120,0,2,422,0
Bacteroides_stercoris_56735,700117537,SRR413559,1938,2184171,328963,1424851,782,395,19969,84080,729,266,308994,1340771,53,129,175873,3839282,7158,10681,241175,384,4,124,1,1,265,0
Bacteroides_stercoris_56735,700117537,SRR413580,6157,2182184,328543,1423553,2602,1032,73972,313470,2562,910,254571,1110083,40,122,146791,3177503,5955,39844,899000,1566,2,120,0,1,909,0
Bacteroides_stercoris_56735,700117537,SRR413581,6042,2182034,328559,1423527,2574,1019,71091,301318,2520,884,257468,1122209,54,135,148291,3212348,5988,38206,864224,1524,4,131,0,1,883,0
Bacteroides_stercoris_56735,700117537,SRR413627,6350,2196629,330751,1432944,2661,1074,74636,316279,2616,936,256115,1116665,45,138,147571,3196433,5991,40183,907061,1593,3,135,0,1,935,0
Bacteroides_stercoris_56735,700117537,SRR413663,6034,2184028,328911,1424871,2569,1013,70707,299452,2519,884,258204,1125419,50,129,148687,3221564,6006,38004,858831,1521,3,126,0,2,882,0
Bacteroides_stercoris_56735,700161533,700163628,984,2202649,331377,1436649,384,194,12983,55548,371,140,318394,1381101,13,54,181520,3954262,7521,6925,159494,225,2,52,0,0,140,0
Bacteroides_stercoris_56735,700161533,ERR911990,2617,2194257,330319,1431157,1021,503,36088,153480,1001,433,294231,1277677,20,70,168512,3657625,6894,19195,440411,834,2,68,0,2,431,0
Bacteroides_stercoris_56735,700161533,ERR911993,560,2196941,330769,1432895,207,124,6891,28884,193,77,323878,1404011,14,47,184205,4020211,7617,3687,82848,117,3,44,0,0,77,0
Bacteroides_stercoris_56735,700161533,SRR413601,55,2184543,328923,1424779,5,35,149,633,2,1,328774,1424146,3,34,186814,4077950,7674,62,1837,0,1,33,0,0,1,0
Bacteroides_stercoris_56735,700161533,SRR413614,5584,2211220,332977,1442380,2185,1100,83104,358369,2115,909,249873,1084011,70,191,143361,3102942,5730,45568,1027505,2034,2,189,0,2,907,0
Bacteroides_stercoris_56735,700161945,700165778,2051,2198913,330989,1434239,851,346,28602,123420,823,270,302387,1310819,28,76,172154,3753298,7005,15810,353799,651,3,72,1,0,270,0
Bacteroides_stercoris_56735,700161945,ERR911974,2312,2196583,330598,1432708,960,446,28502,123086,939,374,302096,1309622,21,72,171976,3749792,7098,15784,352898,576,1,71,0,1,373,0
Bacteroides_stercoris_56735,700161945,ERR912003,1949,2178954,327969,1421179,767,367,29195,126085,738,292,298774,1295094,29,75,169818,3708453,7011,16390,361211,654,1,74,0,1,291,0
Bacteroides_stercoris_56735,700161945,SRR341709,690,2174224,327104,1417844,270,162,8553,36706,250,97,318551,1381138,20,65,181360,3954629,7425,4705,105212,201,2,63,0,0,97,0
Bacteroides_stercoris_56735,700163628,ERR911990,3476,2190449,329551,1428576,1376,643,46814,199646,1357,573,282737,1228930,19,70,162474,3517635,6681,25055,572860,1023,2,68,0,2,571,0
Bacteroides_stercoris_56735,700163628,ERR911993,1298,2193345,330028,1430467,504,242,18086,77040,492,195,311942,1353427,12,47,178096,3874790,7395,9653,221146,321,2,45,0,1,194,0
Bacteroides_stercoris_56735,700163628,ERR912165,977,2206894,332102,1439420,390,188,13313,56847,375,142,318789,1382573,15,46,181719,3958473,7527,7062,163242,237,1,45,0,0,142,0
Bacteroides_stercoris_56735,700163628,SRR413601,967,2178313,327762,1420628,381,189,14070,60352,375,143,313692,1360276,6,46,179015,3894406,7407,7553,173245,258,1,45,0,0,143,0
Bacteroides_stercoris_56735,700163628,SRR413607,971,2205893,331959,1438801,386,187,14809,63355,378,141,317150,1375446,8,46,180822,3938043,7473,7857,181944,264,1,45,0,0,141,0
Bacteroides_stercoris_56735,700163628,SRR413618,979,2206846,332094,1439418,389,191,13965,59794,377,148,318129,1379624,12,43,181341,3950040,7491,7431,171696,255,1,42,0,0,148,0
Bacteroides_stercoris_56735,700163628,SRR413619,979,2206591,332067,1439247,392,187,13501,57707,378,143,318566,1381540,14,44,181581,3955515,7524,7181,165709,231,1,42,1,0,143,0
Bacteroides_stercoris_56735,700164792,ERR911960,2459,2192403,330246,1430091,969,472,32060,137961,944,398,298186,1292130,25,74,169310,3700309,6771,17921,395236,726,2,70,2,2,395,1
Bacteroides_stercoris_56735,700164792,ERR912198,1006,2191087,330072,1429213,403,224,10345,44115,390,167,319727,1385098,13,57,181537,3966488,7269,5570,126547,228,3,53,1,0,167,0
Bacteroides_stercoris_56735,700164792,SRR341646,1290,2135265,319355,1391978,538,250,15413,66782,527,202,303942,1325196,11,48,175628,3792838,7122,8632,191399,315,3,45,0,0,201,1
Bacteroides_stercoris_56735,700164792,SRR413558,71,2193485,330435,1430812,14,44,85,349,2,3,330350,1430463,12,41,187256,4096618,7515,59,988,0,6,35,0,0,3,0
Bacteroides_stercoris_56735,700164792,SRR413594,1963,2192947,330355,1430483,807,354,24001,103057,795,312,306354,1327426,12,42,174144,3801147,6987,13166,295507,498,1,41,0,1,311,0
Bacteroides_stercoris_56735,700165778,ERR911956,2034,2186980,329498,1426392,841,340,28485,122642,812,272,301013,1303750,29,68,171181,3733085,6984,15659,351622,645,3,64,1,0,272,0
Bacteroides_stercoris_56735,700165778,ERR911974,4192,2200076,331520,1435067,1741,730,55064,237330,1723,640,276456,1197737,18,90,157424,3429322,6465,30376,680447,1167,2,87,1,1,639,0
Bacteroides_stercoris_56735,700165778,ERR912003,3452,2182251,328862,1423405,1396,605,50464,216495,1361,514,278398,1206910,35,91,158550,3455685,6495,27679,620678,1128,2,89,0,1,513,0
Bacteroides_stercoris_56735,700165778,SRR341709,2366,2175470,327574,1418711,964,428,34541,148998,940,342,293033,1269713,24,86,166867,3635477,6795,19169,427030,795,3,82,1,0,342,0
Bacteroides_stercoris_56735,700166862,SRR341638,679,2178978,327625,1421073,251,161,7808,32938,238,119,319817,1388135,13,42,182575,3974426,7404,3880,94757,177,1,41,0,0,119,0
Bacteroides_stercoris_56735,700166862,SRR413562,715,2196361,330887,1432648,268,170,7935,33515,246,118,322952,1399133,22,52,183612,4006380,7407,3956,96406,183,2,50,0,0,118,0
Bacteroides_stercoris_56735,700166862,SRR413616,726,2200818,331585,1435576,268,173,7726,32688,241,118,323859,1402888,27,55,184074,4017141,7449,3868,94025,171,0,55,0,0,118,0
Bacteroides_stercoris_56735,700166862,SRR413621,694,2200562,331562,1435410,246,185,7934,33410,224,116,323628,1402000,22,69,183970,4014587,7443,3926,96127,177,0,69,0,0,116,0
Bacteroides_stercoris_56735,700167825,1089275-24-28-0_,1083,2175623,327621,1419243,394,234,12458,52212,344,129,315163,1367031,50,105,179423,3914302,7368,6566,149839,231,1,104,0,1,128,0
Bacteroides_stercoris_56735,700167825,700171679,2635,2185733,329165,1425928,1074,466,29363,123974,1025,369,299802,1301954,49,97,171596,3727258,7008,15224,356080,618,0,97,0,2,367,0
Bacteroides_stercoris_56735,700167825,700172346,1839,2169097,326454,1415003,687,337,18592,78621,647,249,307862,1336382,40,88,175622,3826324,7200,9749,225736,378,2,86,0,2,247,0
Bacteroides_stercoris_56735,700167825,ERR912001,1443,2186982,329365,1426746,556,284,14843,62910,506,184,314522,1363836,50,100,178986,3905190,7332,7912,180509,309,4,96,0,1,183,0
Bacteroides_stercoris_56735,700167825,ERR912018,1994,2183004,328779,1424105,791,405,25781,110115,744,275,302998,1313990,47,130,172606,3762260,7104,13923,315900,522,3,127,0,1,274,0
Bacteroides_stercoris_56735,700167825,ERR912022,1957,2180349,328263,1422395,789,375,25777,110035,741,272,302486,1312360,48,103,172452,3757509,7119,13921,315665,519,1,102,0,1,271,0
Bacteroides_stercoris_56735,700171679,1089275-24-28-0_,3382,2192119,330074,1429904,1361,582,38178,161009,1308,469,291896,1268895,53,113,167492,3632281,6912,19943,462292,792,1,112,0,3,466,0
Bacteroides_stercoris_56735,700171679,700172346,3482,2193802,330188,1430923,1417,596,40453,171655,1375,498,289735,1259268,42,98,166096,3604868,6840,21297,492831,837,2,96,0,5,493,0
Bacteroides_stercoris_56735,700171679,ERR912001,3929,2212448,333147,1443171,1585,672,43471,184420,1521,561,289676,1258751,64,111,166151,3603313,6789,22862,529447,951,3,108,0,4,557,0
Bacteroides_stercoris_56735,700171679,ERR912018,4018,2208860,332638,1440773,1639,701,47725,202871,1588,567,284913,1237902,51,134,163344,3543594,6768,25352,582268,993,0,134,0,6,561,0
Bacteroides_stercoris_56735,700171679,ERR912022,4074,2205933,332092,1438867,1672,698,48349,205508,1619,587,283743,1233359,53,111,162794,3530518,6765,25706,589819,999,1,109,1,3,584,0
Bacteroides_stercoris_56735,700171679,ERR912173,2667,2200129,331245,1435036,1064,489,30315,128237,1019,393,300930,1306799,45,96,172340,3740995,7062,15750,368301,660,3,93,0,2,391,0
Bacteroides_stercoris_56735,700172346,1089275-24-28-0_,1313,2173525,327120,1417687,476,283,12290,51487,432,186,314830,1366200,44,97,179561,3911683,7356,6236,147943,282,2,95,0,1,185,0
Bacteroides_stercoris_56735,700172346,ERR912001,3146,2193163,330065,1430523,1228,530,33955,143561,1181,432,296110,1286962,47,98,169397,3684520,6969,17901,412089,693,7,91,0,3,429,0
Bacteroides_stercoris_56735,700172346,ERR912018,2167,2190127,329665,1428495,857,425,26521,112682,811,293,303144,1315813,46,132,173014,3767330,7095,14018,323440,588,5,127,0,2,291,0
Bacteroides_stercoris_56735,700172346,ERR912022,2170,2192985,330083,1430367,865,410,26732,113856,824,304,303351,1316511,41,106,173048,3769369,7116,14246,326734,588,4,102,0,1,303,0
Bacteroides_stercoris_56735,700172346,ERR912173,1877,2181174,328216,1422614,701,339,18860,79665,664,254,309356,1342949,37,85,176504,3845086,7257,9902,228715,378,6,79,0,2,252,0
Bacteroides_stercoris_56735,700172813,ERR911960,2443,2193471,330438,1430794,963,462,32113,138233,943,399,298325,1292561,20,63,169356,3701559,6768,17967,396003,729,1,62,0,1,397,1
Bacteroides_stercoris_56735,700172813,ERR912198,1003,2192033,330238,1429832,405,218,10307,43915,392,164,319931,1385917,13,54,181655,3968827,7269,5538,125970,237,1,52,1,0,164,0
Bacteroides_stercoris_56735,700172813,SRR341646,1282,2135807,319449,1392341,536,243,15575,67437,529,202,303874,1324904,7,41,175591,3791993,7128,8715,193278,318,1,39,1,0,201,1
Bacteroides_stercoris_56735,700172813,SRR413558,67,2194223,330569,1431309,12,44,87,355,2,3,330482,1430954,10,41,187323,4098015,7524,60,1005,0,4,36,1,0,3,0
Bacteroides_stercoris_56735,700172813,SRR413594,1971,2193857,330510,1431090,811,358,24189,103744,801,316,306321,1327346,10,42,174116,3800917,7005,13260,297477,495,0,41,1,0,316,0
Bacteroides_stercoris_56735,ERR911956,ERR911974,2298,2189109,329830,1427817,956,448,28283,121908,929,375,301547,1305909,27,73,171355,3739298,7074,15634,349508,582,1,72,0,1,374,0
Bacteroides_stercoris_56735,ERR911956,ERR912003,1953,2183246,329012,1424019,767,367,29156,125807,734,292,299856,1298212,33,75,170043,3717573,7020,16315,360467,639,1,74,0,1,291,0
Bacteroides_stercoris_56735,ERR911960,ERR912198,3017,2193039,330408,1430512,1218,565,40226,173415,1192,482,290182,1257097,26,83,164755,3599954,6582,22472,496870,903,2,80,1,1,480,1
Bacteroides_stercoris_56735,ERR911974,ERR912003,4120,2184663,329223,1425010,1680,759,58084,250418,1653,675,271139,1174592,27,84,154077,3363276,6423,32330,717694,1230,0,84,0,2,673,0
Bacteroides_stercoris_56735,ERR911990,ERR911993,3081,2192887,330195,1430232,1214,583,43414,184267,1192,522,286781,1245965,22,61,164496,3566646,6753,23139,528690,972,3,58,0,2,520,0
Bacteroides_stercoris_56735,ERR911990,ERR912165,2625,2199356,331167,1434496,1028,501,35952,153047,1003,434,295215,1281449,25,67,168954,3668463,6930,19175,439132,834,1,66,0,2,432,0
Bacteroides_stercoris_56735,ERR911993,ERR912165,553,2202354,331674,1436434,209,117,6919,28996,193,78,324755,1407438,16,39,184603,4030046,7665,3707,83170,111,2,37,0,0,78,0
Bacteroides_stercoris_56735,ERR912001,1089275-24-28-0_,2394,2193744,330335,1430968,937,427,26473,112241,876,314,303862,1318727,61,113,173490,3775530,7161,14026,322160,537,5,108,0,2,312,0
Bacteroides_stercoris_56735,ERR912001,ERR912018,3227,2211005,332961,1442179,1313,582,40362,171904,1263,448,292599,1270275,50,134,167196,3636690,6939,21634,493262,816,7,127,0,2,446,0
Bacteroides_stercoris_56735,ERR912001,ERR912022,3189,2207668,332356,1440027,1311,550,40186,171314,1260,440,292170,1268713,51,110,167010,3632193,6936,21591,491538,813,5,105,0,2,438,0
Bacteroides_stercoris_56735,ERR912001,ERR912173,1478,2201981,331533,1436252,575,282,15236,64425,524,182,316297,1371827,51,100,180123,3927936,7422,8071,184886,318,7,93,0,1,181,0
Bacteroides_stercoris_56735,ERR912018,1089275-24-28-0_,1452,2190227,329829,1428637,576,323,19614,83816,526,192,310215,1344821,50,131,176647,3850529,7287,10549,240464,435,4,127,0,0,192,0
Bacteroides_stercoris_56735,ERR912018,ERR912173,2030,2197348,330844,1433177,805,405,25358,108469,762,279,305486,1324708,43,126,174064,3792845,7215,13725,311166,516,6,120,0,1,278,0
Bacteroides_stercoris_56735,ERR912022,1089275-24-28-0_,1424,2187596,329320,1426943,577,297,19616,83793,524,188,309704,1343150,53,109,176502,3845667,7281,10551,240387,441,2,106,1,0,188,0
Bacteroides_stercoris_56735,ERR912022,ERR912173,2001,2195538,330479,1432036,806,377,25394,108589,761,275,305085,1323447,45,102,173932,3789194,7215,13753,311495,519,4,98,0,1,274,0
Bacteroides_stercoris_56735,ERR912032,ERR912055,77,2145156,323019,1398941,14,52,122,521,2,3,322897,1398420,12,49,183445,4004396,7419,78,1485,0,4,45,0,0,3,0
Bacteroides_stercoris_56735,ERR912032,ERR912191,60,2165977,326131,1412578,12,39,118,502,2,4,326013,1412076,10,35,185167,4043540,7521,77,1429,0,4,31,0,0,4,0
Bacteroides_stercoris_56735,ERR912173,1089275-24-28-0_,1113,2184651,328947,1424923,406,235,10652,45158,356,134,318295,1379765,50,101,181188,3950619,7488,5665,129611,198,4,97,0,1,133,0
Bacteroides_stercoris_56735,SRR341618,SRR341624,2987,2148061,322181,1400346,1225,537,48216,206450,1182,409,273965,1193896,43,128,158304,3416913,6471,26519,591703,1128,6,121,1,2,407,0
Bacteroides_stercoris_56735,SRR341618,SRR341640,5773,2088842,313703,1362216,2423,994,81593,347439,2382,866,232110,1014777,41,128,134696,2904109,5526,44404,996080,1833,3,125,0,2,864,0
Bacteroides_stercoris_56735,SRR341618,SRR413559,2040,2156934,324428,1406930,822,418,34416,147434,778,285,290012,1259496,44,133,165529,3606245,6714,18930,422625,747,4,128,1,3,282,0
Bacteroides_stercoris_56735,SRR341618,SRR413580,6464,2161201,324900,1409696,2700,1105,89058,379085,2662,975,235842,1030611,38,130,136616,2949661,5556,48487,1086845,1923,2,128,0,4,971,0
Bacteroides_stercoris_56735,SRR341618,SRR413581,6294,2157117,324344,1407130,2651,1080,85478,363867,2603,950,238866,1043263,48,130,138204,2985993,5592,46389,1043346,1866,4,126,0,3,947,0
Bacteroides_stercoris_56735,SRR341618,SRR413627,6528,2166766,325830,1413357,2717,1118,88600,376784,2675,976,237230,1036573,42,142,137354,2966776,5589,48098,1080319,1935,2,140,0,3,973,0
Bacteroides_stercoris_56735,SRR341618,SRR413663,6297,2160469,324871,1409314,2648,1080,84710,360243,2603,952,240161,1049071,45,128,138947,3002632,5634,45931,1032947,1851,3,125,0,4,948,0
Bacteroides_stercoris_56735,SRR341624,SRR341640,5479,2091887,313734,1363574,2348,901,71618,303404,2297,772,242116,1060170,51,129,141602,3033103,5805,38452,870140,1620,4,124,1,1,771,0
Bacteroides_stercoris_56735,SRR341624,SRR341645,2848,2116564,316486,1378970,1143,521,46900,201368,1101,392,269586,1177602,42,129,157149,3369234,6423,26136,576858,1110,7,121,1,2,390,0
Bacteroides_stercoris_56735,SRR341624,SRR341710,3052,2149827,322532,1401523,1256,552,48379,207132,1209,418,274153,1194391,47,134,158392,3418334,6447,26615,593674,1107,6,127,1,2,416,0
Bacteroides_stercoris_56735,SRR341624,SRR413559,1233,2161933,324618,1409506,494,233,14981,63412,463,140,309637,1346094,31,93,177817,3853268,7197,7949,181924,363,2,91,0,0,140,0
Bacteroides_stercoris_56735,SRR341624,SRR413580,6240,2156266,323700,1405816,2664,1018,79611,337290,2622,893,244089,1068526,42,125,142609,3057182,5787,42846,967284,1740,3,121,1,3,890,0
Bacteroides_stercoris_56735,SRR341624,SRR413581,5999,2158882,324100,1407578,2586,981,75685,320668,2529,851,248415,1086910,57,130,145003,3109841,5886,40595,919756,1653,5,124,1,2,849,0
Bacteroides_stercoris_56735,SRR341624,SRR413627,6428,2169715,325719,1414545,2727,1053,80724,342161,2679,912,244995,1072384,48,141,143104,3068231,5817,43417,981290,1776,4,136,1,2,910,0
Bacteroides_stercoris_56735,SRR341624,SRR413663,5995,2160618,324401,1408740,2582,978,75710,320737,2528,852,248691,1088003,54,126,145066,3113051,5892,40706,919843,1662,4,121,1,3,849,0
Bacteroides_stercoris_56735,SRR341638,SRR413621,266,2186324,328645,1425860,78,97,1947,8536,56,29,326698,1417324,22,68,186087,4058313,7572,1020,24528,60,1,67,0,0,29,0
Bacteroides_stercoris_56735,SRR341640,SRR341645,5545,2053638,307311,1338112,2307,959,79728,340205,2266,827,227583,997907,41,132,133504,2854751,5466,43969,974819,1827,4,127,1,2,825,0
Bacteroides_stercoris_56735,SRR341640,SRR341710,5855,2090515,314120,1363319,2458,1020,82308,350124,2414,886,231812,1013195,44,134,134521,2899586,5478,44702,1003843,1827,3,131,0,2,884,0
Bacteroides_stercoris_56735,SRR341640,SRR413559,5165,2101700,316153,1370738,2222,877,65451,277391,2173,751,250702,1093347,49,126,144724,3129425,5892,35107,795656,1410,2,123,1,2,749,0
Bacteroides_stercoris_56735,SRR341640,SRR413580,504,2109480,317218,1375821,161,153,5724,24639,112,47,311494,1351182,49,106,177497,3868822,7227,3165,70593,159,1,104,1,0,47,0
Bacteroides_stercoris_56735,SRR341640,SRR413627,529,2114681,318019,1379208,161,166,5715,24616,112,49,312304,1354592,49,117,177868,3878654,7254,3174,70515,159,2,114,1,0,49,0
Bacteroides_stercoris_56735,SRR341645,SRR413559,1954,2116617,317175,1379328,781,404,33003,141818,735,266,284172,1237510,46,138,164166,3541701,6663,18420,406290,744,5,132,1,3,263,0
Bacteroides_stercoris_56735,SRR341645,SRR413580,6221,2121081,317684,1382241,2581,1066,86444,368812,2540,930,231240,1013429,41,136,135544,2899241,5502,47683,1056839,1914,2,134,0,4,926,0
Bacteroides_stercoris_56735,SRR341645,SRR413627,6283,2126161,318535,1385545,2596,1080,87038,371151,2551,936,231497,1014394,45,144,135611,2902054,5517,47937,1063566,1950,3,141,0,3,933,0
Bacteroides_stercoris_56735,SRR341645,SRR413663,6046,2119988,317601,1381604,2521,1040,83594,356626,2476,914,234007,1024978,45,126,136968,2932401,5565,46020,1021989,1869,3,123,0,4,910,0
Bacteroides_stercoris_56735,SRR341646,ERR911960,3139,2137112,319655,1393224,1263,551,42382,183666,1239,479,277273,1209558,24,72,160374,3461805,6495,24009,526065,924,2,69,1,1,478,0
Bacteroides_stercoris_56735,SRR341646,ERR912198,423,2136258,319560,1392644,174,90,5935,25901,166,57,313625,1366743,8,33,180896,3911968,7365,3387,74235,81,2,31,0,0,56,1
Bacteroides_stercoris_56735,SRR341646,SRR413558,1278,2144384,320775,1398004,533,239,15392,66678,520,198,305383,1331326,13,41,176379,3810486,7113,8618,191095,321,4,37,0,0,197,1
Bacteroides_stercoris_56735,SRR341646,SRR413594,1394,2145793,320997,1398930,573,228,19573,85279,566,206,301424,1313651,7,22,174011,3759844,7098,11106,244368,363,1,21,0,0,205,1
Bacteroides_stercoris_56735,SRR341697,SRR413566,4007,2209495,332553,1441287,1633,728,64286,275682,1601,646,268267,1165605,32,82,153540,3337092,6183,35274,790269,1503,1,81,0,5,641,0
Bacteroides_stercoris_56735,SRR341697,SRR413665,4034,2211123,332845,1442330,1647,766,67380,288179,1606,659,265465,1154151,41,107,151696,3304592,6165,37229,825775,1533,2,104,1,4,655,0
Bacteroides_stercoris_56735,SRR341709,ERR911956,695,2176240,327631,1419198,268,160,8576,36737,247,100,319055,1382461,21,60,181410,3958548,7425,4708,105299,204,2,58,0,0,100,0
Bacteroides_stercoris_56735,SRR341709,ERR911974,2599,2177761,327915,1420233,1072,501,33761,145922,1052,425,294154,1274311,20,76,167383,3648641,6909,18778,418274,714,1,75,0,1,424,0
Bacteroides_stercoris_56735,SRR341709,ERR912003,2531,2171791,327090,1416373,1000,475,37908,163335,974,394,289182,1253038,26,81,164396,3587959,6759,21143,468016,846,1,80,0,1,393,0
Bacteroides_stercoris_56735,SRR341710,SRR413559,2094,2161852,325389,1410203,855,425,34827,148951,806,286,290562,1261252,49,139,165777,3611289,6690,19083,427020,750,4,134,1,3,283,0
Bacteroides_stercoris_56735,SRR341710,SRR413580,6545,2165433,325761,1412511,2741,1123,88862,377705,2700,991,236899,1034806,41,132,137198,2961679,5541,48225,1082979,1911,2,130,0,4,987,0
Bacteroides_stercoris_56735,SRR341710,SRR413627,6618,2172002,326838,1416824,2761,1141,89238,379148,2715,995,237600,1037676,46,146,137529,2969934,5565,48348,1087167,1929,2,144,0,3,992,0
Bacteroides_stercoris_56735,SRR341710,SRR413663,6381,2165532,325859,1412694,2692,1099,85767,364577,2645,970,240092,1048117,47,129,138862,2999885,5604,46429,1045439,1863,3,126,0,4,966,0
Bacteroides_stercoris_56735,SRR413558,ERR911960,2468,2195865,330797,1432434,969,475,32085,138070,942,403,298712,1294364,27,72,169532,3706795,6765,17931,395553,726,5,66,1,1,401,1
Bacteroides_stercoris_56735,SRR413558,ERR912198,990,2193586,330463,1430898,398,216,10520,44766,386,162,319943,1386132,12,54,181631,3969520,7245,5649,128397,252,5,49,0,0,162,0
Bacteroides_stercoris_56735,SRR413558,SRR413594,1958,2202821,331890,1437001,801,352,24003,103010,787,309,307887,1333991,14,43,174894,3820086,6993,13173,295353,504,4,39,0,0,309,0
Bacteroides_stercoris_56735,SRR413559,SRR413580,5842,2172328,327293,1417205,2508,985,72433,306686,2462,864,254860,1110519,46,121,146690,3178948,5919,38846,879697,1515,1,119,1,4,860,0
Bacteroides_stercoris_56735,SRR413559,SRR413581,5697,2175275,327749,1419188,2468,964,69693,295222,2410,840,258056,1123966,58,124,148402,3217523,5973,37284,846918,1464,3,120,1,3,837,0
Bacteroides_stercoris_56735,SRR413559,SRR413627,5983,2183926,329097,1424772,2559,1010,73475,310996,2510,885,255622,1113776,49,125,147108,3188277,5943,39313,892142,1533,2,122,1,3,882,0
Bacteroides_stercoris_56735,SRR413559,SRR413663,5693,2177055,328066,1420405,2464,958,69366,293732,2410,837,258700,1126673,54,121,148737,3225294,5988,37124,842602,1470,2,118,1,4,833,0
Bacteroides_stercoris_56735,SRR413562,SRR413621,231,2203416,331884,1437241,75,75,1985,8711,61,28,329899,1428530,14,47,187145,4090867,7578,1044,25029,60,2,45,0,0,28,0
Bacteroides_stercoris_56735,SRR413566,SRR413665,2855,2218836,334265,1447406,1166,551,43509,186661,1126,460,290756,1260745,40,91,165779,3609772,6684,23709,535254,1020,1,89,1,1,459,0
Bacteroides_stercoris_56735,SRR413580,SRR413581,529,2180622,328392,1422695,172,162,5790,24706,116,47,322602,1397989,56,115,183211,4003406,7350,3157,70802,159,2,113,0,0,47,0
Bacteroides_stercoris_56735,SRR413580,SRR413663,520,2183981,328955,1424884,164,159,6031,25758,117,52,322924,1399126,47,107,183349,4006658,7371,3310,73805,159,1,106,0,0,52,0
Bacteroides_stercoris_56735,SRR413581,SRR413627,556,2189988,329884,1428793,173,175,5811,24828,116,49,324073,1403965,57,126,183892,4020605,7398,3181,71144,159,3,123,0,0,49,0
Bacteroides_stercoris_56735,SRR413585,ERR912066,77,2181409,328470,1422951,11,49,140,567,4,0,328330,1422384,7,49,186233,4073470,7449,65,1633,3,2,47,0,0,0,0
Bacteroides_stercoris_56735,SRR413594,ERR911960,3810,2195405,330734,1432143,1554,673,51649,222945,1531,601,279085,1209198,23,72,158521,3462731,6342,28952,638746,1137,1,70,1,1,599,1
Bacteroides_stercoris_56735,SRR413594,ERR912198,1078,2194110,330573,1431261,431,187,14509,62688,424,157,316064,1368573,7,30,179279,3919234,7206,8069,179719,276,1,29,0,0,157,0
Bacteroides_stercoris_56735,SRR413601,ERR911990,2524,2180165,328275,1421891,982,490,35496,151226,962,419,292779,1270665,20,71,167641,3637517,6837,18962,433891,825,1,70,0,2,417,0
Bacteroides_stercoris_56735,SRR413601,ERR911993,534,2183161,328746,1423854,197,117,6882,28875,188,74,321864,1394979,9,43,183150,3994236,7551,3687,82824,114,2,41,0,0,74,0
Bacteroides_stercoris_56735,SRR413601,ERR912165,53,2186729,329286,1426220,8,30,150,533,2,0,329136,1425687,6,30,187032,4082343,7686,48,1545,6,0,30,0,0,0,0
Bacteroides_stercoris_56735,SRR413601,SRR413614,5419,2185337,329100,1425318,2112,1080,84895,365605,2057,891,244205,1059713,55,189,140438,3033109,5592,46508,1048219,2088,1,188,0,2,889,0
Bacteroides_stercoris_56735,SRR413607,ERR911990,2597,2197843,330955,1433553,1016,497,35867,152654,994,423,295088,1280899,22,74,168842,3666970,6885,19121,438004,837,1,73,0,2,421,0
Bacteroides_stercoris_56735,SRR413607,ERR911993,551,2200782,331446,1435442,205,121,6900,28928,192,77,324546,1406514,13,44,184473,4027449,7620,3694,82976,114,2,42,0,0,77,0
Bacteroides_stercoris_56735,SRR413607,ERR912165,50,2215150,333631,1444946,11,25,309,1270,4,3,333322,1443676,7,22,189133,4134137,7758,135,3663,12,0,22,0,0,3,0
Bacteroides_stercoris_56735,SRR413607,SRR413614,5552,2215355,333691,1445105,2181,1085,84355,363565,2121,903,249336,1081540,60,182,143010,3095925,5685,46241,1042381,2073,1,181,0,2,901,0
Bacteroides_stercoris_56735,SRR413607,SRR413619,56,2219566,334366,1447853,12,31,309,1268,3,4,334057,1446585,9,27,189456,4142529,7770,136,3656,12,0,27,0,0,4,0
Bacteroides_stercoris_56735,SRR413614,ERR912165,5607,2212546,333188,1443228,2189,1112,86251,371774,2131,927,246937,1071454,58,185,141833,3066853,5676,47247,1065936,2139,1,184,0,3,924,0
Bacteroides_stercoris_56735,SRR413614,SRR413618,5571,2216475,333858,1445841,2186,1092,86978,375112,2131,905,246880,1070729,55,187,141668,3064882,5637,47684,1075513,2139,1,186,0,2,903,0
Bacteroides_stercoris_56735,SRR413616,SRR413621,246,2208530,332687,1440585,78,77,2006,8793,60,29,330681,1431792,18,48,187562,4100203,7611,1056,25263,60,0,48,0,0,29,0
Bacteroides_stercoris_56735,SRR413618,ERR911990,2598,2199011,331129,1434317,1019,495,35685,151895,994,427,295444,1282422,25,68,169031,3671332,6903,19042,435806,837,1,67,0,2,425,0
Bacteroides_stercoris_56735,SRR413618,ERR911993,540,2201772,331585,1436089,206,113,6891,28896,190,78,324694,1407193,16,35,184571,4029385,7623,3692,82882,114,2,33,0,0,78,0
Bacteroides_stercoris_56735,SRR413618,ERR912165,77,2216240,333801,1445654,15,40,160,569,3,1,333641,1445085,12,39,189303,4138176,7776,52,1649,6,0,39,0,0,1,0
Bacteroides_stercoris_56735,SRR413619,ERR911990,2609,2198639,331073,1434068,1021,497,35912,152830,995,430,295161,1281238,26,67,168926,3667888,6900,19125,438522,843,1,66,0,2,428,0
Bacteroides_stercoris_56735,SRR413619,ERR911993,552,2201491,331550,1435895,209,116,6902,28932,191,78,324648,1406963,18,38,184555,4028696,7638,3695,82987,114,2,36,0,0,78,0
Bacteroides_stercoris_56735,SRR413627,SRR413663,548,2191689,330186,1429948,165,173,6039,25781,117,54,324147,1404167,48,119,183914,4021180,7407,3315,73869,159,3,116,0,0,54,0
