species_name,sample 1,sample 2,core_diff,core_len,core_len_4D,core_len_1D,core_diff_4D,core_diff_1D,recomb_len_4D,recomb_len_1D,recomb_diff_4D,recomb_diff_1D,clonal_len_4D,clonal_len_1D,clonal_diff_4D,clonal_diff_1D,clonal_n,clonal_m,clonal_nn,recomb_n,recomb_m,recomb_nn,clonal_mut_n,clonal_mut_m,clonal_mut_nn,recomb_mut_n,recomb_mut_m,recomb_mut_nn
Bacteroides_caccae_53434,700013715,700014562,1327,3194575,456343,2080554,486,387,66481,302999,469,312,389862,1777555,17,75,267238,5056937,8490,45627,861954,1416,4,71,0,4,308,0
Bacteroides_caccae_53434,700013715,700021902,570,3207338,457977,2088862,206,179,22741,105061,191,105,435236,1983801,15,74,298253,5643547,9603,15904,298736,543,0,74,0,1,104,0
Bacteroides_caccae_53434,700013715,700023267,245,3198938,456611,2083376,82,89,6177,27540,62,26,450434,2055836,20,63,309500,5848021,9987,3938,78550,132,3,60,0,1,25,0
Bacteroides_caccae_53434,700013715,700023337,786,3196379,456468,2081752,291,236,27771,127208,272,170,428697,1954544,19,66,294174,5559987,9471,18879,362130,615,2,64,0,1,169,0
Bacteroides_caccae_53434,700013715,700023919,575,3206628,457876,2088398,209,182,22755,105130,192,105,435121,1983268,17,77,298184,5642032,9588,15915,298932,543,1,76,0,1,104,0
Bacteroides_caccae_53434,700013715,700024437,578,3206148,457750,2088081,208,189,22738,105033,191,103,435012,1983048,17,86,298164,5641368,9612,15907,298649,543,2,84,0,1,102,0
Bacteroides_caccae_53434,700013715,700034166,228,3204776,457624,2087238,74,93,6045,27040,57,25,451579,2060198,17,68,310021,5860637,9936,3869,77125,126,1,67,0,1,24,0
Bacteroides_caccae_53434,700013715,700034926,213,3194511,456043,2080511,63,89,5777,25931,50,26,450266,2054580,13,63,309305,5844496,9939,3721,73943,129,3,60,0,1,25,0
Bacteroides_caccae_53434,700013715,700035533,273,3197813,456656,2082656,91,101,6196,27684,67,27,450460,2054972,24,74,309221,5845741,9954,3950,78970,132,2,72,0,1,26,0
Bacteroides_caccae_53434,700013715,700035861,217,3193787,456551,2080097,68,95,5789,25947,50,25,450762,2054150,18,70,309019,5843906,9525,3723,73995,123,0,70,0,1,24,0
Bacteroides_caccae_53434,700013715,700037090,211,3204939,457623,2087316,64,88,5808,26018,50,25,451815,2061298,14,63,310186,5863706,10002,3731,74194,129,2,61,0,1,24,0
Bacteroides_caccae_53434,700013715,700038386,557,3160685,449545,2058512,204,175,22785,105730,187,101,426760,1952782,17,74,294501,5554425,9420,16046,300607,537,3,71,0,1,100,0
Bacteroides_caccae_53434,700013715,700100600,560,3200239,456716,2084265,213,168,22772,105278,192,103,433944,1978987,21,65,297676,5629781,9504,15939,299346,549,2,63,0,1,102,0
Bacteroides_caccae_53434,700013715,700101243,569,3200483,456894,2084429,214,174,22738,105096,192,103,434156,1979333,22,71,297615,5630865,9519,15918,298827,543,1,70,0,1,102,0
Bacteroides_caccae_53434,700013715,700102586,231,3206057,457779,2088039,75,92,5780,25902,51,25,451999,2062137,24,67,310307,5866096,10008,3715,73862,129,2,64,1,1,24,0
Bacteroides_caccae_53434,700013715,700102659,1613,3194574,456446,2080583,604,435,56627,258306,588,370,399819,1822277,16,65,273845,5184244,8742,38909,734749,1260,0,65,0,2,368,0
Bacteroides_caccae_53434,700013715,700105049,215,3206669,457861,2088427,63,90,5809,26023,50,25,452052,2062404,13,65,310394,5866801,10017,3732,74208,129,2,63,0,1,24,0
Bacteroides_caccae_53434,700013715,700106836,237,3203988,457463,2086698,71,105,5802,25998,50,25,451661,2060700,21,80,310109,5861980,10011,3730,74135,129,1,79,0,1,24,0
Bacteroides_caccae_53434,700013715,700111156,943,3201811,457151,2085293,340,282,32345,147630,307,196,424806,1937663,33,86,291771,5511789,9429,21850,420359,681,3,83,0,1,195,0
Bacteroides_caccae_53434,700013715,700113867,214,3206501,457887,2088310,67,85,5806,26012,50,26,452081,2062298,17,59,310329,5866572,9993,3731,74176,129,0,59,0,1,25,0
Bacteroides_caccae_53434,700013715,700114480,574,3184917,454001,2074298,211,180,22595,104614,188,101,431406,1969684,23,79,296538,5603046,9468,15844,297458,540,1,78,0,1,100,0
Bacteroides_caccae_53434,700013715,700116296,204,3205990,457817,2087995,64,85,5803,26000,51,25,452014,2061995,13,60,310289,5865682,10014,3730,74141,129,0,60,0,1,24,0
Bacteroides_caccae_53434,700013715,700161743,188,3205783,457667,2087865,63,70,5802,26005,50,25,451865,2061860,13,45,310313,5865286,9981,3732,74154,129,1,44,0,1,24,0
Bacteroides_caccae_53434,700013715,700161872,779,3206951,457941,2088617,323,204,32835,146864,303,143,425106,1941753,20,61,292527,5523351,9381,21593,418249,750,1,60,0,2,141,0
Bacteroides_caccae_53434,700013715,700161967,976,3206581,457840,2088385,378,268,37046,167263,364,185,420794,1921122,14,83,289443,5464596,9327,24659,476332,798,1,82,0,2,183,0
Bacteroides_caccae_53434,700013715,700171859,221,3204108,457508,2086772,67,93,5802,25998,50,25,451706,2060774,17,68,310118,5862193,10011,3730,74135,129,1,67,0,1,24,0
Bacteroides_caccae_53434,700013715,700172279,238,3207648,458063,2089064,63,109,5806,26012,50,25,452257,2063052,13,84,310443,5868699,10014,3731,74176,129,0,84,0,1,24,0
Bacteroides_caccae_53434,700013715,700172393,239,3206562,457875,2088349,68,107,5807,26014,51,25,452068,2062335,17,82,310357,5866640,10008,3731,74182,129,0,82,0,1,24,0
Bacteroides_caccae_53434,700013715,700172498,572,3200243,456942,2084299,208,183,22759,105134,192,105,434183,1979165,16,78,297503,5630404,9588,15912,298947,543,2,76,0,1,104,0
Bacteroides_caccae_53434,700013715,700173546,584,3204117,457514,2086762,219,170,22289,103033,187,97,435225,1983729,32,73,298231,5643371,9585,15600,292959,540,1,72,0,1,96,0
Bacteroides_caccae_53434,700013715,ERR912014,225,3181726,454616,2072259,67,95,5795,25957,50,25,448821,2046302,17,70,307696,5821292,9918,3721,74021,129,1,69,0,1,24,0
Bacteroides_caccae_53434,700013715,ERR912100,665,3207480,458004,2088973,266,178,25075,113187,250,110,432929,1975786,16,68,297303,5620482,9573,16859,322144,558,1,67,0,2,108,0
Bacteroides_caccae_53434,700013715,ERR912124,586,3192328,455666,2079128,230,161,22212,100805,215,96,433454,1978323,15,65,297713,5627671,9585,15069,286833,513,0,65,0,1,95,0
Bacteroides_caccae_53434,700013715,ERR912164,234,3205944,457779,2087980,71,96,5856,26243,53,26,451923,2061737,18,70,310268,5864935,10008,3769,74831,129,0,70,0,1,25,0
Bacteroides_caccae_53434,700014562,700021902,1280,3200405,457170,2084382,455,391,60838,277478,441,308,396332,1806904,14,83,271539,5140533,8640,41932,789215,1287,4,79,0,3,305,0
Bacteroides_caccae_53434,700014562,700023267,1259,3190677,455641,2078006,452,372,57128,260400,429,281,398513,1817606,23,91,273254,5170873,8691,39328,740657,1215,6,85,0,4,277,0
Bacteroides_caccae_53434,700014562,700023337,1798,3184449,454932,2074003,662,520,78683,359766,640,422,376249,1714237,22,98,257647,4876901,8163,54208,1023386,1704,7,91,0,3,419,0
Bacteroides_caccae_53434,700014562,700023919,1293,3196701,456636,2081962,461,399,57227,260834,442,294,399409,1821128,19,105,273756,5180913,8715,39332,741967,1203,5,100,0,3,291,0
Bacteroides_caccae_53434,700014562,700024437,1286,3194856,456321,2080741,455,403,60765,277186,441,304,395556,1803555,14,99,271015,5131010,8640,41895,788382,1281,7,92,0,3,301,0
Bacteroides_caccae_53434,700014562,700034166,1246,3198094,456844,2082913,449,375,61079,278694,429,291,395765,1804219,20,84,271098,5132976,8583,42121,792659,1302,5,79,0,3,288,0
Bacteroides_caccae_53434,700014562,700034926,1223,3183277,454606,2073184,434,371,68703,311499,418,296,385903,1761685,16,75,265085,5011591,8379,46799,886231,1467,6,69,0,4,292,0
Bacteroides_caccae_53434,700014562,700035533,1295,3185922,455131,2074924,463,392,57113,260364,436,277,398018,1814560,27,115,272673,5162361,8646,39289,740591,1212,7,108,0,3,274,0
Bacteroides_caccae_53434,700014562,700035861,1237,3191874,456330,2078878,440,380,60791,277205,421,294,395539,1801673,19,86,270636,5126082,8301,41926,788417,1272,5,81,0,3,291,0
Bacteroides_caccae_53434,700014562,700037090,1230,3200730,457235,2084601,437,371,60900,277913,421,293,396335,1806688,16,78,271452,5139987,8625,42033,790404,1302,6,72,0,3,290,0
Bacteroides_caccae_53434,700014562,700038386,1268,3157345,449318,2056345,451,391,56272,257142,434,292,393046,1799203,17,99,271283,5117743,8583,38905,731336,1185,7,92,0,4,288,0
Bacteroides_caccae_53434,700014562,700100600,1273,3192008,455714,2078941,461,383,56956,259628,441,293,398758,1819313,20,90,273579,5175699,8661,39163,738524,1197,7,83,0,3,290,0
Bacteroides_caccae_53434,700014562,700101243,1282,3189836,455536,2077520,462,391,56741,258569,440,291,398795,1818951,22,100,273440,5174731,8682,39005,735514,1188,6,94,0,3,288,0
Bacteroides_caccae_53434,700014562,700102586,1254,3198805,456931,2083340,445,381,65660,297538,421,285,391271,1785802,24,96,268666,5080232,8508,44652,846546,1416,6,89,1,4,281,0
Bacteroides_caccae_53434,700014562,700102659,1739,3186476,455401,2075343,641,463,59657,272173,626,389,395744,1803170,15,74,270809,5130127,8574,41128,774146,1245,4,70,0,4,385,0
Bacteroides_caccae_53434,700014562,700105049,1232,3195021,456397,2080863,437,374,60710,277125,421,291,395687,1803738,16,83,270997,5131595,8622,41917,788165,1293,6,77,0,3,288,0
Bacteroides_caccae_53434,700014562,700106836,1257,3197925,456813,2082781,444,388,60872,277760,420,297,395941,1805021,24,91,271177,5135261,8625,42005,789973,1302,5,86,0,3,294,0
Bacteroides_caccae_53434,700014562,700111156,1955,3195845,456528,2081444,712,561,83486,381189,680,451,373042,1700255,32,110,255655,4836974,8136,57320,1084477,1770,8,102,0,3,448,0
Bacteroides_caccae_53434,700014562,700113867,1232,3194870,456398,2080763,438,373,56544,257693,420,282,399854,1823070,18,91,273954,5186550,8706,38913,732966,1200,5,86,0,3,279,0
Bacteroides_caccae_53434,700014562,700114480,1273,3173800,452614,2067057,454,393,59014,269892,429,296,393600,1797165,25,97,270416,5112541,8538,40834,767585,1257,6,91,0,3,293,0
Bacteroides_caccae_53434,700014562,700116296,1216,3194512,456334,2080544,437,365,60705,276982,419,288,395629,1803562,18,77,270985,5131079,8622,41877,787776,1293,4,73,0,3,285,0
Bacteroides_caccae_53434,700014562,700161743,1210,3195580,456411,2081242,438,357,56836,259213,420,275,399575,1822029,18,82,273838,5183558,8691,39155,737272,1212,5,77,0,3,272,0
Bacteroides_caccae_53434,700014562,700161872,1365,3196082,456551,2081561,510,410,62787,286028,494,331,393764,1795533,16,79,269709,5108289,8601,43309,813473,1302,6,73,0,4,327,0
Bacteroides_caccae_53434,700014562,700161967,1599,3198459,456869,2083146,585,479,73259,333366,570,383,383610,1749780,15,96,263266,4977671,8403,50007,948582,1509,5,91,0,4,379,0
Bacteroides_caccae_53434,700014562,700171859,1241,3195835,456546,2081396,441,379,60734,277184,421,294,395812,1804212,20,85,271055,5132956,8625,41930,788326,1296,5,80,0,4,290,0
Bacteroides_caccae_53434,700014562,700172279,1256,3196740,456685,2081998,436,394,60522,276113,420,291,396163,1805885,16,103,271319,5137705,8631,41746,785309,1284,5,98,0,3,288,0
Bacteroides_caccae_53434,700014562,700172393,1259,3195153,456431,2080934,441,393,60490,275983,420,292,395941,1804951,21,101,271178,5135047,8628,41742,784920,1287,5,96,0,3,289,0
Bacteroides_caccae_53434,700014562,700172498,1286,3192267,456027,2079123,456,401,60792,277272,443,311,395235,1801851,13,90,270693,5126232,8628,41897,788641,1278,7,83,0,3,308,0
Bacteroides_caccae_53434,700014562,700173546,1299,3198256,456891,2082971,469,385,55733,254052,443,288,401158,1828919,26,97,274886,5203117,8754,38316,722667,1173,5,92,0,3,285,0
Bacteroides_caccae_53434,700014562,ERR912014,1177,3177836,454278,2069769,414,360,57836,262598,396,274,396442,1807171,18,86,271508,5141389,8616,39508,747059,1227,5,81,0,2,272,0
Bacteroides_caccae_53434,700014562,ERR912100,1286,3199597,457051,2083881,469,391,61408,279873,454,312,395643,1804008,15,79,271034,5132356,8634,42327,796002,1290,5,74,0,4,308,0
Bacteroides_caccae_53434,700014562,ERR912124,1215,3186165,454965,2075145,439,371,59097,270200,424,293,395868,1804945,15,78,271207,5134988,8640,40977,768375,1248,5,73,0,3,290,0
Bacteroides_caccae_53434,700014562,ERR912164,1258,3198119,456842,2082916,447,382,60728,277030,426,295,396114,1805886,21,87,271326,5137704,8628,41911,787889,1290,4,83,0,3,292,0
Bacteroides_caccae_53434,700014724,ERR912086,106,3167602,452082,2063075,24,64,901,3825,2,0,451181,2059250,22,64,309823,5858012,9915,494,10969,12,2,62,0,0,0,0
Bacteroides_caccae_53434,700014724,mickey4-11-0-0_,127,3164811,451568,2061241,28,83,904,3831,2,0,450664,2057410,26,83,309636,5852676,9918,494,10987,12,1,82,0,0,0,0
Bacteroides_caccae_53434,700014837,700024615,1337,3174157,453030,2067219,482,350,41466,185950,448,243,411564,1881269,34,107,283464,5351229,9114,27524,529438,888,2,105,0,1,242,0
Bacteroides_caccae_53434,700014837,700037405,782,3198696,456648,2083287,290,195,32603,146138,276,121,424045,1937149,14,74,291426,5510607,9414,21960,415809,645,4,70,0,2,119,0
Bacteroides_caccae_53434,700014837,700037852,1335,3192109,455482,2079044,471,359,41339,185449,438,241,414143,1893595,33,118,285387,5386236,9162,27452,528019,876,2,116,0,1,240,0
Bacteroides_caccae_53434,700014837,700038072,150,3194736,456131,2080777,41,65,1997,8647,27,8,454134,2072130,14,57,311793,5894589,10008,1163,24739,39,4,52,1,0,8,0
Bacteroides_caccae_53434,700014837,700095058,1414,3189306,455493,2077244,527,356,44873,202048,495,260,410620,1875196,32,96,282303,5334345,8940,30056,575125,963,1,95,0,3,257,0
Bacteroides_caccae_53434,700014837,700113114,288,3199373,456774,2083741,109,83,16365,73515,93,28,440409,2010226,16,55,302900,5718085,9693,10526,209656,363,1,54,0,1,27,0
Bacteroides_caccae_53434,700014837,700114218,1358,3199653,456852,2083950,491,356,47492,212806,448,247,409360,1871144,43,109,281913,5322510,9009,31523,605872,1023,1,108,0,1,246,0
Bacteroides_caccae_53434,700014837,ERR912168,1555,3202002,457134,2085470,593,380,52907,239167,553,288,404227,1846303,40,92,278209,5251751,8949,35465,680941,1095,1,91,0,1,287,0
Bacteroides_caccae_53434,700015250,ERR912055,559,3197984,456779,2082839,194,177,15626,70467,169,85,441153,2012372,25,92,302443,5724956,9717,10787,200245,369,2,90,0,1,84,0
Bacteroides_caccae_53434,700021361,700096865,992,3181658,454747,2072169,358,313,28764,126253,310,160,425983,1945916,48,153,293307,5535099,9342,17993,360154,612,2,151,0,3,157,0
Bacteroides_caccae_53434,700021361,700106229,1003,3209418,458273,2090208,367,318,28767,126327,308,159,429506,1963881,59,159,296377,5585723,9543,18013,360338,630,2,157,0,3,156,0
Bacteroides_caccae_53434,700021361,pluto3-11-30-0_,348,3209253,458277,2090104,84,161,5006,21476,36,21,453271,2068628,48,140,311428,5884421,10035,2929,61364,135,5,135,0,0,21,0
Bacteroides_caccae_53434,700021902,700023267,496,3200885,456862,2084660,172,159,17337,80723,152,83,439525,2003937,20,76,301252,5700836,9723,12398,229354,417,3,73,0,0,83,0
Bacteroides_caccae_53434,700021902,700023337,1039,3196929,456535,2082125,382,312,38942,180393,363,226,417593,1901732,19,86,285776,5410213,9207,27339,512940,900,2,84,0,0,226,0
Bacteroides_caccae_53434,700021902,700034166,485,3210275,458430,2090829,166,166,17198,80216,148,82,441232,2010613,18,84,302137,5720036,9666,12328,227903,417,1,83,0,0,82,0
Bacteroides_caccae_53434,700021902,700034926,448,3195123,456113,2080896,148,151,16684,77486,137,77,439429,2003410,11,74,301197,5699355,9678,11876,220177,405,3,71,0,0,77,0
Bacteroides_caccae_53434,700021902,700035533,527,3198636,456766,2083195,181,176,17326,80728,158,83,439440,2002467,23,93,300850,5696864,9687,12390,229377,417,2,91,0,0,83,0
Bacteroides_caccae_53434,700021902,700035861,465,3199169,457306,2083618,158,164,16392,76444,134,78,440914,2007174,24,86,301528,5710724,9270,11780,217156,396,0,86,0,0,78,0
Bacteroides_caccae_53434,700021902,700037090,464,3210896,458459,2091221,155,160,16461,76884,133,75,441998,2014337,22,85,302691,5730570,9750,11853,218394,405,2,83,0,0,75,0
Bacteroides_caccae_53434,700021902,700102586,482,3211804,458589,2091798,163,165,16957,79153,138,82,441632,2012645,25,83,302430,5725755,9750,12191,224854,414,1,81,1,1,81,0
Bacteroides_caccae_53434,700021902,700102659,1564,3198411,456973,2083096,579,436,51616,236143,563,365,405357,1846953,16,71,277359,5254623,8877,35784,671502,1143,0,71,0,1,364,0
Bacteroides_caccae_53434,700021902,700105049,466,3208008,458042,2089310,154,161,16964,79188,141,80,441078,2010122,13,81,302050,5718572,9744,12187,224963,414,2,79,0,0,80,0
Bacteroides_caccae_53434,700021902,700106836,486,3207928,458007,2089302,160,175,16964,79163,139,85,441043,2010139,21,90,302049,5718618,9750,12189,224886,414,1,89,0,0,85,0
Bacteroides_caccae_53434,700021902,700111156,1202,3205886,457715,2087981,432,361,43519,200867,399,260,414196,1887114,33,101,283725,5368449,9168,30309,571326,966,3,98,0,0,260,0
Bacteroides_caccae_53434,700021902,700113867,476,3207808,458070,2089169,160,164,16956,79097,142,83,441114,2010072,18,81,302003,5718490,9723,12172,224705,414,0,81,0,0,83,0
Bacteroides_caccae_53434,700021902,700116296,455,3207173,457971,2088769,155,156,16959,79082,141,80,441012,2009687,14,76,301961,5717356,9744,12170,224662,414,0,76,0,0,80,0
Bacteroides_caccae_53434,700021902,700161743,441,3208219,458002,2089458,154,143,16961,79154,141,80,441041,2010304,13,63,302097,5719101,9714,12180,224868,414,1,62,0,0,80,0
Bacteroides_caccae_53434,700021902,700161872,726,3209026,458214,2089981,282,213,24099,110131,268,140,434115,1979850,14,73,297601,5632343,9606,16728,313125,540,1,72,0,1,139,0
Bacteroides_caccae_53434,700021902,700161967,645,3211367,458512,2091541,230,210,20850,94373,215,112,437662,1997168,15,98,300631,5681111,9762,13948,268775,396,1,97,0,1,111,0
Bacteroides_caccae_53434,700021902,700171859,482,3206404,457822,2088292,160,169,16976,79221,141,82,440846,2009071,19,87,301880,5715586,9747,12197,225052,414,1,86,0,0,82,0
Bacteroides_caccae_53434,700021902,700172279,490,3209852,458364,2090519,154,180,16972,79185,142,83,441392,2011334,12,97,302207,5722054,9741,12187,224954,414,0,97,0,0,83,0
Bacteroides_caccae_53434,700021902,700172393,495,3208170,458085,2089417,159,181,16975,79212,142,84,441110,2010205,17,97,302036,5718835,9744,12196,225026,414,0,97,0,0,84,0
Bacteroides_caccae_53434,700021902,ERR912014,432,3188566,455606,2076745,140,148,14349,65982,124,68,441257,2010763,16,80,302112,5720451,9726,10006,187589,351,1,79,0,0,68,0
Bacteroides_caccae_53434,700021902,ERR912100,332,3212604,458710,2092350,117,118,9032,41093,107,41,449678,2051257,10,77,308392,5835389,9990,6300,116808,171,1,76,0,1,40,0
Bacteroides_caccae_53434,700021902,ERR912124,257,3199278,456661,2083689,82,104,6821,31791,72,28,449840,2051898,10,76,308506,5837186,10002,5005,90239,129,0,76,0,0,28,0
Bacteroides_caccae_53434,700021902,ERR912164,486,3210993,458491,2091301,162,168,16958,79141,142,83,441533,2012160,20,85,302357,5724379,9744,12195,224814,414,0,85,0,0,83,0
Bacteroides_caccae_53434,700023267,700023337,719,3188885,455199,2076867,257,227,22345,102727,237,149,432854,1974140,20,78,297061,5615768,9591,15366,292317,498,5,73,0,0,149,0
Bacteroides_caccae_53434,700023267,700023919,503,3200646,456825,2084489,174,163,17336,80727,153,83,439489,2003762,21,80,301223,5700343,9720,12407,229357,417,4,76,0,0,83,0
Bacteroides_caccae_53434,700023267,700024437,499,3199397,456593,2083683,170,168,16810,78334,144,74,439783,2005349,26,94,301462,5704856,9729,12049,222545,408,5,89,0,0,74,0
Bacteroides_caccae_53434,700023267,700034166,131,3197847,456460,2082728,25,72,359,1483,7,0,456101,2081245,18,72,313121,5920564,10050,202,4244,3,4,68,0,0,0,0
Bacteroides_caccae_53434,700023267,700034926,135,3187219,454833,2075731,29,67,359,1478,12,2,454474,2074253,17,65,312185,5900515,10059,203,4228,3,6,59,0,0,2,0
Bacteroides_caccae_53434,700023267,700035533,171,3190431,455434,2077825,35,83,397,1680,12,1,455037,2076145,23,82,312308,5906047,10080,220,4817,3,5,77,0,0,1,0
Bacteroides_caccae_53434,700023267,700035861,142,3189775,455842,2077473,32,76,369,1522,12,1,455473,2075951,20,75,312242,5905969,9642,207,4356,3,3,72,0,0,1,0
Bacteroides_caccae_53434,700023267,700037090,137,3200979,456891,2084729,28,70,369,1522,12,1,456522,2083207,16,69,313446,5926041,10134,207,4356,3,5,64,0,0,1,0
Bacteroides_caccae_53434,700023267,700038386,485,3158396,449154,2057003,170,155,17047,79655,140,74,432107,1977348,30,81,298139,5624344,9561,12272,226288,405,6,75,0,0,74,0
Bacteroides_caccae_53434,700023267,700100600,483,3193983,455687,2080166,176,148,17348,80824,153,82,438339,1999342,23,66,300672,5687718,9636,12415,229640,417,5,61,0,0,82,0
Bacteroides_caccae_53434,700023267,700101243,496,3193717,455761,2080020,179,155,17315,80646,153,81,438446,1999374,26,74,300539,5687947,9636,12399,229122,417,4,70,0,0,81,0
Bacteroides_caccae_53434,700023267,700102586,155,3199300,456632,2083625,37,74,369,1522,12,1,456263,2082103,25,73,313263,5922912,10134,207,4356,3,5,67,1,0,1,0
Bacteroides_caccae_53434,700023267,700102659,1547,3187357,455228,2075858,570,418,51172,233744,549,349,404056,1842114,21,69,276777,5240709,8856,35384,664714,1134,2,67,0,2,347,0
Bacteroides_caccae_53434,700023267,700105049,134,3199319,456624,2083648,27,68,369,1519,12,1,456255,2082129,15,67,313286,5922964,10137,206,4348,3,3,64,0,0,1,0
Bacteroides_caccae_53434,700023267,700106836,160,3199842,456715,2083994,37,82,767,3416,13,1,455948,2080578,24,81,312968,5918629,10137,560,9679,9,4,77,0,0,1,0
Bacteroides_caccae_53434,700023267,700111156,873,3197564,456378,2082516,303,273,26882,123018,271,176,429496,1959498,32,97,294998,5573941,9555,18316,350174,564,6,91,0,0,176,0
Bacteroides_caccae_53434,700023267,700113867,150,3199018,456627,2083429,31,75,369,1522,12,1,456258,2081907,19,74,313230,5922372,10119,207,4356,3,3,71,0,0,1,0
Bacteroides_caccae_53434,700023267,700114480,499,3178796,453048,2070263,175,161,17223,80321,149,80,435825,1989942,26,81,299475,5660757,9594,12342,228207,414,4,77,0,0,80,0
Bacteroides_caccae_53434,700023267,700116296,129,3198516,456552,2083119,30,64,369,1522,12,1,456183,2081597,18,63,313188,5921475,10128,207,4356,3,3,60,0,0,1,0
Bacteroides_caccae_53434,700023267,700161743,107,3199280,456549,2083608,26,48,369,1519,12,1,456180,2082089,14,47,313318,5922839,10110,206,4348,3,2,45,0,0,1,0
Bacteroides_caccae_53434,700023267,700161872,696,3200027,456757,2084100,284,182,27343,122159,263,122,429414,1961941,21,60,295517,5580805,9501,18045,347811,621,2,58,0,1,121,0
Bacteroides_caccae_53434,700023267,700161967,906,3200440,456770,2084379,340,256,30824,139030,323,161,425946,1945349,17,95,293105,5533474,9468,20526,395904,660,4,91,0,1,160,0
Bacteroides_caccae_53434,700023267,700171859,159,3200263,456797,2084261,35,81,369,1519,12,1,456428,2082742,23,80,313377,5924700,10149,206,4348,3,4,76,0,0,1,0
Bacteroides_caccae_53434,700023267,700172279,160,3200882,456899,2084658,29,88,369,1522,12,1,456530,2083136,17,87,313422,5925858,10128,207,4356,3,3,84,0,0,1,0
Bacteroides_caccae_53434,700023267,700172393,165,3199475,456687,2083727,32,89,369,1517,12,1,456318,2082210,20,88,313287,5923212,10131,205,4343,3,3,85,0,0,1,0
Bacteroides_caccae_53434,700023267,700172498,498,3196330,456227,2081744,172,164,17332,80711,153,83,438895,2001033,19,81,300749,5692636,9714,12399,229317,417,5,76,0,0,83,0
Bacteroides_caccae_53434,700023267,700173546,504,3200270,456791,2084246,183,151,17317,80636,153,81,439474,2003610,30,70,301171,5699939,9720,12385,229106,417,4,66,0,0,81,0
Bacteroides_caccae_53434,700023267,ERR912014,147,3178563,454009,2070191,31,74,369,1522,12,1,453640,2068669,19,73,311010,5884944,10053,207,4356,3,4,69,0,0,1,0
Bacteroides_caccae_53434,700023267,ERR912100,596,3201383,456928,2084982,230,163,18923,85290,211,88,438005,1999692,19,75,300899,5688472,9705,12798,242643,429,4,71,0,1,87,0
Bacteroides_caccae_53434,700023267,ERR912124,522,3186879,454684,2075585,197,148,16789,76381,177,76,437895,1999204,20,72,300826,5687072,9714,11555,217201,387,3,69,0,0,76,0
Bacteroides_caccae_53434,700023267,ERR912164,157,3199794,456691,2083977,35,76,459,1971,18,1,456232,2082006,17,75,313281,5922615,10122,282,5622,9,3,72,0,0,1,0
Bacteroides_caccae_53434,700023337,700023919,1062,3196598,456473,2081896,387,323,38954,180454,365,229,417519,1901442,22,94,285741,5409390,9195,27347,513106,909,3,91,0,0,229,0
Bacteroides_caccae_53434,700023337,700024437,1045,3195810,456311,2081391,383,318,38911,180249,363,221,417400,1901142,20,97,285713,5408506,9207,27319,512525,903,3,94,0,1,220,0
Bacteroides_caccae_53434,700023337,700034166,714,3194779,456246,2080753,255,232,22238,102325,232,146,434008,1978428,23,86,297591,5628153,9540,15297,291186,492,3,83,0,1,145,0
Bacteroides_caccae_53434,700023337,700034926,689,3184474,454626,2074018,239,225,21896,100924,223,148,432730,1973094,16,77,296889,5612847,9546,15120,287166,486,4,73,0,1,147,0
Bacteroides_caccae_53434,700023337,700035533,739,3194517,456196,2080519,261,246,22326,102657,236,145,433870,1977862,25,101,297543,5626458,9585,15337,292145,489,4,97,0,0,145,0
Bacteroides_caccae_53434,700023337,700035861,687,3183384,455095,2073372,244,230,21957,101067,224,139,433138,1972305,20,91,296586,5611200,9129,15127,287600,474,2,89,0,0,139,0
Bacteroides_caccae_53434,700023337,700037090,683,3194471,456167,2080543,240,224,21976,101262,223,148,434191,1979281,17,76,297709,5630531,9603,15163,288134,489,4,72,0,0,148,0
Bacteroides_caccae_53434,700023337,700038386,1012,3150727,448166,2052054,370,305,38796,180206,350,223,409370,1871848,20,82,282144,5324364,9036,27400,512333,885,4,78,0,1,222,0
Bacteroides_caccae_53434,700023337,700100600,1030,3190118,455315,2077707,389,299,38999,180785,365,223,416316,1896922,24,76,285185,5396470,9111,27398,514054,903,4,72,0,0,223,0
Bacteroides_caccae_53434,700023337,700101243,1044,3190538,455499,2077992,388,310,38851,180092,362,224,416648,1897900,26,86,285233,5399347,9120,27297,512079,900,3,83,0,0,224,0
Bacteroides_caccae_53434,700023337,700102586,711,3195888,456368,2081448,249,234,21977,101244,222,148,434391,1980204,27,86,297856,5633141,9615,15158,288085,489,4,81,1,0,148,0
Bacteroides_caccae_53434,700023337,700102659,2077,3184451,455032,2074029,778,562,72763,333314,757,493,382269,1740715,21,69,261438,4952370,8337,50305,948020,1617,2,67,0,1,492,0
Bacteroides_caccae_53434,700023337,700105049,686,3196487,456454,2081835,238,225,21977,101248,222,145,434477,1980587,16,80,297929,5634214,9618,15156,288096,492,4,76,0,0,145,0
Bacteroides_caccae_53434,700023337,700106836,713,3193969,456066,2080214,246,241,21986,101316,222,146,434080,1978898,24,95,297663,5629416,9615,15164,288298,486,3,92,0,0,146,0
Bacteroides_caccae_53434,700023337,700111156,374,3193721,456003,2080028,111,155,10582,49414,76,61,445421,2030614,35,94,305338,5776631,9873,7487,140521,234,4,90,0,1,60,0
Bacteroides_caccae_53434,700023337,700113867,692,3196253,456464,2081667,243,223,21987,101270,221,142,434477,1980397,22,81,297882,5633709,9600,15159,288165,486,2,79,0,0,142,0
Bacteroides_caccae_53434,700023337,700114480,1035,3175265,452679,2068042,383,311,38151,177060,348,216,414528,1890982,35,95,284525,5379334,9087,26867,503431,882,3,92,0,0,216,0
Bacteroides_caccae_53434,700023337,700116296,674,3195962,456410,2081496,239,220,21977,101260,222,142,434433,1980236,17,78,297861,5633226,9621,15162,288132,486,2,76,0,0,142,0
Bacteroides_caccae_53434,700023337,700161743,662,3195499,456238,2081197,240,206,21967,101225,224,142,434271,1979972,16,64,297860,5632465,9591,15157,288023,495,3,61,0,0,142,0
Bacteroides_caccae_53434,700023337,700161872,1255,3196607,456505,2081918,497,342,49013,222099,475,266,407492,1859819,22,76,280063,5290409,8985,33021,632172,1104,3,73,0,1,265,0
Bacteroides_caccae_53434,700023337,700161967,1465,3196503,456432,2081859,558,410,52345,238242,538,306,404087,1843617,20,104,277709,5244193,8949,35383,678200,1143,3,101,0,1,305,0
Bacteroides_caccae_53434,700023337,700171859,700,3194004,456104,2080216,245,228,21988,101273,223,146,434116,1978943,22,82,297673,5629535,9621,15156,288174,489,3,79,0,0,146,0
Bacteroides_caccae_53434,700023337,700172279,709,3197404,456619,2082441,239,245,21986,101317,225,144,434633,1981124,14,101,297972,5635782,9618,15174,288291,486,2,99,0,0,144,0
Bacteroides_caccae_53434,700023337,700172393,716,3196438,456474,2081797,243,246,21997,101320,226,144,434477,1980477,17,102,297897,5633913,9621,15168,288306,486,2,100,0,0,144,0
Bacteroides_caccae_53434,700023337,700172498,1046,3189973,455512,2077653,382,319,38422,178051,354,219,417090,1899602,28,100,285408,5404200,9198,26990,506269,894,3,97,0,1,218,0
Bacteroides_caccae_53434,700023337,700173546,1057,3193807,456072,2080083,393,307,38898,180148,367,227,417174,1899935,26,80,285499,5405108,9198,27304,512231,909,3,77,0,1,226,0
Bacteroides_caccae_53434,700023337,ERR912014,692,3172025,453250,2065968,242,225,21946,101126,223,145,431304,1964842,19,80,295321,5589668,9537,15141,287748,489,3,77,0,0,145,0
Bacteroides_caccae_53434,700023337,ERR912100,1148,3197213,456574,2082316,444,317,41215,188289,423,236,415359,1894027,21,81,284871,5388030,9180,28265,535681,921,3,78,0,1,235,0
Bacteroides_caccae_53434,700023337,ERR912124,1069,3182078,454233,2072484,410,299,39077,179362,390,221,415156,1893122,20,78,284747,5385421,9198,27024,510186,876,2,76,0,0,221,0
Bacteroides_caccae_53434,700023337,ERR912164,714,3195622,456332,2081299,248,237,21986,101314,227,144,434346,1979985,21,93,297847,5632499,9609,15156,288291,495,2,91,0,0,144,0
Bacteroides_caccae_53434,700023919,700034166,492,3206542,457883,2088399,167,171,17194,80208,149,82,440689,2008191,18,89,301738,5713175,9660,12333,227874,417,2,87,0,0,82,0
Bacteroides_caccae_53434,700023919,700034926,459,3194857,456066,2080721,152,157,16679,77454,138,77,439387,2003267,14,80,301200,5698929,9672,11870,220087,405,4,76,0,0,77,0
Bacteroides_caccae_53434,700023919,700035533,536,3198073,456682,2082816,184,184,17330,80745,159,83,439352,2002071,25,101,300800,5695735,9678,12398,229420,417,3,98,0,0,83,0
Bacteroides_caccae_53434,700023919,700035861,477,3195271,456757,2081079,162,170,16394,76462,135,78,440363,2004617,27,92,301108,5703485,9258,11785,217205,396,1,91,0,0,78,0
Bacteroides_caccae_53434,700023919,700037090,475,3206959,457903,2088656,159,165,16467,76906,134,75,441436,2011750,25,90,302286,5723229,9735,11855,218458,405,3,87,0,0,75,0
Bacteroides_caccae_53434,700023919,700102586,492,3207969,458048,2089289,167,169,16959,79171,139,82,441089,2010118,28,87,302032,5718584,9738,12191,224908,414,2,84,1,1,81,0
Bacteroides_caccae_53434,700023919,700102659,1575,3196359,456691,2081740,583,443,49876,228393,561,357,406815,1853347,22,86,278361,5272788,8892,34587,649476,1116,1,85,0,1,356,0
Bacteroides_caccae_53434,700023919,700105049,474,3207109,457908,2088719,158,163,16964,79189,142,80,440944,2009530,16,83,301973,5716876,9741,12190,224963,414,3,80,0,0,80,0
Bacteroides_caccae_53434,700023919,700106836,500,3205868,457724,2087933,164,183,16968,79179,140,85,440756,2008754,24,98,301829,5714701,9732,12194,224929,414,2,96,0,0,85,0
Bacteroides_caccae_53434,700023919,700111156,1221,3203568,457401,2086459,437,370,43531,200910,401,263,413870,1885549,36,107,283506,5363994,9147,30310,571445,975,4,103,0,0,263,0
Bacteroides_caccae_53434,700023919,700113867,489,3207022,457948,2088650,164,171,16954,79091,143,83,440994,2009559,21,88,301952,5717005,9720,12165,224694,414,1,87,0,0,83,0
Bacteroides_caccae_53434,700023919,700116296,468,3206448,457865,2088298,159,163,16447,76759,134,74,441418,2011539,25,89,302261,5722612,9744,11824,218048,405,1,88,0,0,74,0
Bacteroides_caccae_53434,700023919,700161743,450,3207530,457895,2088999,158,147,16970,79178,142,80,440925,2009821,16,67,302060,5717686,9717,12183,224937,414,2,65,0,0,80,0
Bacteroides_caccae_53434,700023919,700161872,739,3208423,458130,2089586,289,220,23661,108091,264,135,434469,1981495,25,85,297875,5637007,9603,16420,307322,531,2,83,0,1,134,0
Bacteroides_caccae_53434,700023919,700161967,657,3209252,458201,2090142,232,220,21338,96675,225,117,436863,1993467,7,103,300105,5670555,9741,14287,275336,402,2,101,0,1,116,0
Bacteroides_caccae_53434,700023919,700171859,493,3205877,457746,2087940,164,176,16962,79163,142,82,440784,2008777,22,94,301862,5714728,9741,12186,224889,414,2,92,0,0,82,0
Bacteroides_caccae_53434,700023919,700172279,498,3209138,458264,2090049,158,183,16457,76866,135,77,441807,2013183,23,106,302504,5727304,9741,11848,218345,405,1,105,0,0,77,0
Bacteroides_caccae_53434,700023919,700172393,500,3207539,458002,2088990,162,183,16977,79215,143,84,441025,2009775,19,99,302001,5717589,9735,12196,225035,414,1,98,0,0,84,0
Bacteroides_caccae_53434,700023919,700173546,121,3206139,457785,2088095,20,64,50,253,3,0,457735,2087842,17,64,314016,5939370,10140,34,719,6,2,62,0,0,0,0
Bacteroides_caccae_53434,700023919,ERR912014,439,3184475,455008,2074043,144,151,14348,65975,125,68,440660,2008068,19,83,301704,5712792,9708,10001,187573,351,2,81,0,0,68,0
Bacteroides_caccae_53434,700023919,ERR912100,347,3210408,458406,2090886,123,126,9115,41431,109,42,449291,2049455,14,84,308133,5830245,9987,6344,117778,171,2,82,0,1,41,0
Bacteroides_caccae_53434,700023919,ERR912124,266,3195178,456059,2081001,86,109,6819,31802,72,29,449240,2049199,14,80,308087,5829526,9984,5004,90273,129,1,79,0,0,29,0
Bacteroides_caccae_53434,700023919,ERR912164,496,3208603,458144,2089727,166,174,17013,79398,146,84,441131,2010329,20,90,302074,5719184,9729,12237,225543,414,1,89,0,0,84,0
Bacteroides_caccae_53434,700024437,700034166,493,3204562,457537,2087099,168,175,17609,82106,153,81,439928,2004993,15,94,301232,5704087,9660,12657,233235,426,4,90,0,0,81,0
Bacteroides_caccae_53434,700024437,700034926,462,3194214,455929,2080303,151,164,16688,77501,137,75,439241,2002802,14,89,301117,5697605,9684,11889,220209,405,5,84,0,0,75,0
Bacteroides_caccae_53434,700024437,700035533,537,3197336,456519,2082339,183,188,17323,80720,158,80,439196,2001619,25,108,300748,5694425,9684,12392,229348,420,4,104,0,0,80,0
Bacteroides_caccae_53434,700024437,700035861,471,3193676,456463,2080034,158,173,16382,76404,134,75,440081,2003630,24,98,300986,5700643,9261,11778,217038,396,2,96,0,0,75,0
Bacteroides_caccae_53434,700024437,700037090,470,3204855,457545,2087275,155,169,16459,76881,133,72,441086,2010394,22,97,302088,5719350,9744,11852,218386,405,4,93,0,0,72,0
Bacteroides_caccae_53434,700024437,700102586,487,3206187,457737,2088122,161,175,16949,79120,138,79,440788,2009002,23,96,301875,5715390,9741,12188,224758,414,3,92,1,1,78,0
Bacteroides_caccae_53434,700024437,700102659,1568,3194353,456335,2080448,579,444,49855,228297,562,354,406480,1852151,17,90,278198,5269354,8901,34560,649215,1116,2,88,0,1,353,0
Bacteroides_caccae_53434,700024437,700105049,473,3206520,457777,2088349,156,169,16442,76824,133,71,441335,2011525,23,98,302265,5722554,9756,11843,218224,405,4,94,0,0,71,0
Bacteroides_caccae_53434,700024437,700106836,494,3203950,457380,2086694,162,184,16958,79137,139,82,440422,2007557,23,102,301665,5711265,9741,12186,224811,414,3,99,0,0,82,0
Bacteroides_caccae_53434,700024437,700111156,1208,3202028,457118,2085445,432,368,43487,200745,400,257,413631,1884700,32,111,283357,5361581,9162,30301,570965,969,4,107,0,1,256,0
Bacteroides_caccae_53434,700024437,700113867,482,3206041,457739,2088028,158,174,16439,76760,134,74,441300,2011268,24,100,302213,5721853,9738,11823,218052,405,2,98,0,0,74,0
Bacteroides_caccae_53434,700024437,700116296,462,3205515,457679,2087689,157,164,16952,79050,141,77,440727,2008639,16,87,301832,5714338,9747,12160,224576,414,2,85,0,0,77,0
Bacteroides_caccae_53434,700024437,700161743,450,3205961,457616,2087979,155,154,16946,79094,141,77,440670,2008885,14,77,301910,5715025,9720,12176,224692,414,3,74,0,0,77,0
Bacteroides_caccae_53434,700024437,700161872,736,3206955,457848,2088630,284,224,23667,108110,262,131,434181,1980520,22,93,297725,5634217,9618,16423,307376,531,3,90,0,1,130,0
Bacteroides_caccae_53434,700024437,700161967,654,3206934,457814,2088623,230,222,21021,95132,221,110,436793,1993491,9,112,300092,5670631,9750,14071,270929,396,3,109,0,1,109,0
Bacteroides_caccae_53434,700024437,700171859,491,3204186,457458,2086836,162,180,16945,79102,141,79,440513,2007734,21,101,301694,5711761,9747,12177,224715,414,3,98,0,0,79,0
Bacteroides_caccae_53434,700024437,700172279,497,3207663,457977,2089093,156,188,16965,79177,142,80,441012,2009916,14,108,302015,5717986,9747,12188,224929,414,2,106,0,0,80,0
Bacteroides_caccae_53434,700024437,700172393,501,3206406,457773,2088272,159,191,16968,79199,142,81,440805,2009073,17,110,301896,5715579,9744,12197,224986,414,2,108,0,0,81,0
Bacteroides_caccae_53434,700024437,ERR912014,440,3181932,454570,2072397,140,160,14342,65956,124,67,440228,2006441,16,93,301464,5708142,9717,9998,187519,351,3,90,0,0,67,0
Bacteroides_caccae_53434,700024437,ERR912100,339,3207974,458000,2089304,116,130,9116,41410,108,40,448884,2047894,8,90,307894,5825804,9984,6345,117714,171,3,87,0,1,39,0
Bacteroides_caccae_53434,700024437,ERR912124,266,3192655,455626,2079351,82,116,6823,31796,72,27,448803,2047555,10,89,307847,5824822,9996,5008,90251,129,2,87,0,0,27,0
Bacteroides_caccae_53434,700024437,ERR912164,494,3206271,457746,2088205,162,179,16951,79129,142,81,440795,2009076,20,98,301910,5715577,9741,12192,224781,414,2,96,0,0,81,0
Bacteroides_caccae_53434,700024615,700037405,986,3179351,453942,2070576,333,305,27793,124358,297,182,426149,1946218,36,123,293096,5536141,9417,18318,354132,624,5,118,0,0,182,0
Bacteroides_caccae_53434,700024615,700037852,141,3173457,452843,2066760,25,83,281,1184,7,0,452562,2065576,18,83,310809,5875890,10029,165,3384,3,2,81,0,0,0,0
Bacteroides_caccae_53434,700024615,700038072,1397,3172346,452971,2066083,506,375,41822,188051,458,251,411149,1878032,48,124,282828,5342145,9123,27883,535379,891,5,118,1,2,249,0
Bacteroides_caccae_53434,700024615,700095058,252,3169463,452688,2064223,78,107,3805,18215,58,26,448883,2046008,20,81,307474,5820758,9792,2910,51651,84,2,79,0,1,25,0
Bacteroides_caccae_53434,700024615,700113114,1451,3179766,454011,2070857,533,383,53507,241115,499,276,400504,1829742,34,107,275855,5204506,8865,35584,686588,1173,2,105,0,3,273,0
Bacteroides_caccae_53434,700024615,ERR912168,464,3179791,453998,2070870,152,163,15289,71239,132,87,438709,1999631,20,76,300822,5688363,9708,10639,202772,306,1,75,0,0,87,0
Bacteroides_caccae_53434,700024998,700037008,1365,3185638,454699,2074632,499,327,48298,220157,477,228,406401,1854475,22,99,279426,5274867,9132,32662,626795,1014,1,98,0,0,228,0
Bacteroides_caccae_53434,700033665,700037649,1054,3135623,449015,2042331,354,317,39578,180617,326,214,409437,1861714,28,103,279668,5297146,8328,27040,513965,846,4,99,0,2,212,0
Bacteroides_caccae_53434,700033665,700105685,178,3127393,447855,2036955,34,100,3372,16042,13,4,444483,2020913,21,96,303274,5750402,9063,2687,45367,72,2,94,0,0,4,0
Bacteroides_caccae_53434,700033797,700097291,152,3153343,450899,2053831,26,98,482,2202,6,0,450417,2051629,20,98,308218,5837204,9465,308,6274,24,1,97,0,0,0,0
Bacteroides_caccae_53434,700033797,700171648,1403,3156098,450625,2055473,474,394,53806,244357,432,260,396819,1811116,42,134,273746,5151184,8418,35628,696216,1227,2,132,0,0,260,0
Bacteroides_caccae_53434,700033797,ERR912037,4109,3166525,452669,2062362,1541,1070,164126,744866,1506,954,288543,1317496,35,116,198632,3747625,6231,111307,2119886,3405,2,113,1,3,950,1
Bacteroides_caccae_53434,700034166,700034926,129,3192979,455818,2079534,23,77,671,2999,12,3,455147,2076535,11,74,312372,5907222,10011,479,8506,12,4,70,0,0,3,0
Bacteroides_caccae_53434,700034166,700035533,170,3196014,456422,2081516,33,93,256,1056,12,1,456166,2080460,21,92,312844,5918519,10017,141,3024,3,4,88,0,0,1,0
Bacteroides_caccae_53434,700034166,700035861,133,3197309,457036,2082442,27,82,661,2940,12,2,456375,2079502,15,80,312659,5916226,9621,464,8344,12,2,78,0,0,2,0
Bacteroides_caccae_53434,700034166,700037090,129,3207857,458063,2089280,25,77,251,1077,7,0,457812,2088203,18,77,314077,5940461,10071,144,3084,3,3,74,0,0,0,0
Bacteroides_caccae_53434,700034166,700038386,478,3163860,450030,2060632,165,165,17428,81508,144,79,432602,1979124,21,86,298306,5629571,9495,12548,231562,414,5,81,0,0,79,0
Bacteroides_caccae_53434,700034166,700100600,481,3201811,456966,2085337,174,159,18687,87415,155,83,438279,1997922,19,76,300199,5684000,9567,13542,248247,456,4,72,0,0,83,0
Bacteroides_caccae_53434,700034166,700101243,493,3199134,456705,2083598,174,167,17164,80101,149,80,439541,2003497,25,87,301080,5699826,9585,12312,227574,417,3,84,0,0,80,0
Bacteroides_caccae_53434,700034166,700102586,157,3208837,458198,2089900,37,86,241,1018,7,0,457957,2088882,30,86,314188,5942372,10086,132,2919,3,4,81,1,0,0,0
Bacteroides_caccae_53434,700034166,700102659,1538,3196338,456700,2081782,568,422,51185,233824,548,347,405515,1847958,20,75,277517,5257549,8808,35391,664941,1140,1,74,0,1,346,0
Bacteroides_caccae_53434,700034166,700105049,133,3204850,457630,2087282,24,79,241,1020,7,0,457389,2086262,17,79,313791,5934915,10080,131,2926,3,3,76,0,0,0,0
Bacteroides_caccae_53434,700034166,700106836,159,3205300,457668,2087616,30,98,767,3408,8,0,456901,2084208,22,98,313397,5929159,10068,558,9657,9,2,96,0,0,0,0
Bacteroides_caccae_53434,700034166,700111156,873,3203255,457383,2086291,306,278,26805,122720,268,175,430578,1963571,38,103,295494,5585715,9504,18259,349343,558,4,99,0,1,174,0
Bacteroides_caccae_53434,700034166,700113867,139,3205031,457690,2087400,28,81,251,1077,7,0,457439,2086323,21,81,313760,5935150,10059,144,3084,3,2,79,0,0,0,0
Bacteroides_caccae_53434,700034166,700114480,490,3183520,453814,2073435,172,168,16567,77451,137,73,437247,1995984,35,95,300294,5678103,9555,11916,220032,405,3,92,0,0,73,0
Bacteroides_caccae_53434,700034166,700116296,125,3204417,457591,2087007,25,75,251,1077,7,0,457340,2085930,18,75,313705,5934002,10083,144,3084,3,1,74,0,0,0,0
Bacteroides_caccae_53434,700034166,700161743,111,3205038,457575,2087444,24,64,241,1020,7,0,457334,2086424,17,64,313829,5935390,10053,131,2926,3,2,62,0,0,0,0
Bacteroides_caccae_53434,700034166,700161872,706,3205847,457798,2087948,285,200,27419,122639,261,124,430379,1965309,24,76,295851,5590650,9426,18151,349130,636,3,73,0,1,123,0
Bacteroides_caccae_53434,700034166,700161967,903,3208300,458108,2089578,343,257,31434,142004,324,161,426674,1947574,19,96,293271,5540031,9420,20996,404362,654,2,94,0,1,160,0
Bacteroides_caccae_53434,700034166,700171859,144,3203172,457393,2086199,28,87,251,1072,7,0,457142,2085127,21,87,313589,5931718,10074,142,3071,3,3,84,0,0,0,0
Bacteroides_caccae_53434,700034166,700172279,148,3206712,457947,2088512,22,95,251,1077,7,0,457696,2087435,15,95,313932,5938299,10074,144,3084,3,2,93,0,0,0,0
Bacteroides_caccae_53434,700034166,700172393,154,3205093,457683,2087438,27,94,681,3040,12,2,457002,2084398,15,92,313439,5929696,10059,486,8622,12,2,90,0,0,2,0
Bacteroides_caccae_53434,700034166,700172498,495,3199242,456816,2083701,169,175,17127,79896,146,78,439689,2003805,23,97,300970,5700797,9648,12334,226937,417,4,93,0,0,78,0
Bacteroides_caccae_53434,700034166,700173546,496,3205267,457694,2087566,177,159,17192,80197,149,80,440502,2007369,28,79,301603,5710844,9660,12332,227842,417,2,77,0,0,80,0
Bacteroides_caccae_53434,700034166,ERR912014,140,3184921,455104,2074408,28,81,251,1077,7,0,454853,2073331,21,81,311601,5898393,9999,144,3084,3,2,79,0,0,0,0
Bacteroides_caccae_53434,700034166,ERR912100,588,3209207,458267,2090165,230,166,19557,88429,210,88,438710,2001736,20,78,301038,5694522,9648,13292,251563,432,2,76,0,1,87,0
Bacteroides_caccae_53434,700034166,ERR912124,509,3195385,456117,2081190,192,152,17371,79323,173,76,438746,2001867,19,76,301084,5694860,9657,12035,225544,390,2,74,0,0,76,0
Bacteroides_caccae_53434,700034166,ERR912164,152,3207871,458072,2089316,32,86,241,1032,7,0,457831,2088284,25,86,314087,5940682,10083,134,2959,3,1,85,0,0,0,0
Bacteroides_caccae_53434,700034926,700035533,171,3185613,454781,2074735,38,90,387,1654,17,3,454394,2073081,21,87,311892,5897328,10023,218,4738,6,5,82,0,0,3,0
Bacteroides_caccae_53434,700034926,700038386,442,3150741,448098,2052038,148,150,16928,78839,133,74,431170,1973199,15,76,297507,5612592,9498,12112,224003,402,6,70,0,0,74,0
Bacteroides_caccae_53434,700034926,700100600,442,3188846,455010,2076831,156,142,16711,77690,138,76,438299,1999141,18,66,300668,5687167,9588,11916,220743,411,5,61,0,0,76,0
Bacteroides_caccae_53434,700034926,700101243,450,3189031,455147,2076977,155,149,16677,77469,138,75,438470,1999508,17,74,300640,5688278,9606,11879,220123,405,4,70,0,0,75,0
Bacteroides_caccae_53434,700034926,700102659,1498,3182903,454629,2072952,547,415,50217,229210,530,348,404412,1843742,17,67,277072,5245322,8832,34672,651842,1116,3,64,0,1,347,0
Bacteroides_caccae_53434,700034926,700111156,852,3189868,455309,2077533,290,275,26434,121251,258,175,428875,1956282,32,100,294486,5564856,9504,18088,345113,552,5,95,0,1,174,0
Bacteroides_caccae_53434,700034926,700114480,459,3174234,452420,2067342,155,156,16585,77179,134,74,435835,1990163,21,82,299566,5661362,9561,11836,219299,402,4,78,0,0,74,0
Bacteroides_caccae_53434,700034926,700161872,665,3194726,456068,2080653,266,185,26784,119617,249,120,429284,1961036,17,65,295361,5578297,9450,17698,340532,621,3,62,0,2,118,0
Bacteroides_caccae_53434,700034926,700161967,877,3194695,456028,2080644,326,253,29911,134646,310,153,426117,1945998,16,100,293241,5535324,9429,19822,383480,636,3,97,0,2,151,0
Bacteroides_caccae_53434,700034926,700172498,457,3187975,455066,2076314,151,159,16690,77511,138,77,438376,1998803,13,82,300453,5686287,9669,11888,220240,405,5,77,0,0,77,0
Bacteroides_caccae_53434,700034926,700173546,468,3191937,455638,2078829,162,146,16729,77707,141,75,438909,2001122,21,71,300862,5692844,9660,11901,220809,411,4,67,0,0,75,0
Bacteroides_caccae_53434,700034926,ERR912100,562,3195347,456148,2081059,214,162,18039,81079,197,81,438109,1999980,17,81,300983,5689294,9663,12114,230712,411,3,78,0,2,79,0
Bacteroides_caccae_53434,700034926,ERR912124,484,3180228,453807,2071233,176,147,15882,72084,160,69,437925,1999149,16,78,300864,5686908,9675,10867,205016,369,2,76,0,1,68,0
Bacteroides_caccae_53434,700034926,ERR912164,132,3193824,455922,2080074,19,82,60,269,3,0,455862,2079805,16,82,312932,5916406,10077,44,763,0,3,79,0,0,0,0
Bacteroides_caccae_53434,700035533,700035861,142,3184936,455310,2074335,39,69,387,1646,17,2,454923,2072689,22,67,311612,5896861,9594,216,4719,3,2,65,0,0,2,0
Bacteroides_caccae_53434,700035533,700037090,173,3196120,456398,2081567,39,90,387,1663,17,2,456011,2079904,22,88,312781,5916845,10086,218,4768,3,4,84,0,0,2,0
Bacteroides_caccae_53434,700035533,700038386,517,3152025,448341,2052845,178,175,17562,82029,154,80,430779,1970816,24,95,297019,5605934,9495,12615,233058,414,5,90,0,0,80,0
Bacteroides_caccae_53434,700035533,700100600,526,3191342,455476,2078460,190,171,17349,80921,159,82,438127,1997539,31,89,300264,5682762,9591,12417,229926,420,5,84,0,0,82,0
Bacteroides_caccae_53434,700035533,700101243,534,3191933,455700,2078863,189,177,17315,80704,159,81,438385,1998159,30,96,300233,5684647,9597,12396,229296,420,4,92,0,0,81,0
Bacteroides_caccae_53434,700035533,700102586,193,3197388,456568,2082395,50,92,387,1646,17,2,456181,2080749,33,90,312905,5919253,10089,216,4719,3,4,85,1,0,2,0
Bacteroides_caccae_53434,700035533,700102659,1578,3185863,455233,2074903,577,438,51157,233662,548,350,404076,1841241,29,88,276475,5238428,8820,35367,664488,1131,2,86,0,1,349,0
Bacteroides_caccae_53434,700035533,700105049,176,3197834,456651,2082677,38,90,387,1640,17,1,456264,2081037,21,89,312973,5920040,10098,213,4704,3,4,85,0,0,1,0
Bacteroides_caccae_53434,700035533,700106836,196,3195217,456230,2080982,46,102,397,1705,17,2,455833,2079277,29,100,312697,5915045,10089,223,4886,6,3,97,0,0,2,0
Bacteroides_caccae_53434,700035533,700111156,909,3193269,455952,2079721,317,288,26935,123297,278,173,429017,1956424,39,115,294399,5565360,9513,18334,350999,558,5,110,0,0,173,0
Bacteroides_caccae_53434,700035533,700113867,184,3197740,456676,2082596,44,90,387,1663,17,2,456289,2080933,27,88,312929,5919793,10077,218,4768,3,2,86,0,0,2,0
Bacteroides_caccae_53434,700035533,700114480,533,3176060,452766,2068553,186,179,17226,80399,155,80,435540,1988154,31,99,299098,5655809,9555,12348,228435,414,3,96,0,0,80,0
Bacteroides_caccae_53434,700035533,700116296,167,3197277,456595,2082305,39,86,387,1663,17,2,456208,2080642,22,84,312895,5918930,10101,218,4768,3,2,82,0,0,2,0
Bacteroides_caccae_53434,700035533,700161743,147,3197119,456471,2082214,38,69,387,1640,17,1,456084,2080574,21,68,312929,5918728,10065,214,4703,3,3,65,0,0,1,0
Bacteroides_caccae_53434,700035533,700161872,738,3198107,456710,2082852,298,203,27513,123015,270,125,429197,1959837,28,78,295004,5575057,9450,18197,350212,636,3,75,0,1,124,0
Bacteroides_caccae_53434,700035533,700161967,947,3198126,456668,2082866,356,273,31448,141999,328,162,425220,1940867,28,111,292234,5520944,9423,20970,404367,660,2,109,0,2,160,0
Bacteroides_caccae_53434,700035533,700171859,192,3195361,456291,2081067,44,100,387,1663,17,2,455904,2079404,27,98,312710,5915407,10095,218,4768,3,3,95,0,0,2,0
Bacteroides_caccae_53434,700035533,700172279,161,3198962,456855,2083401,34,82,387,1651,17,2,456468,2081750,17,80,313041,5922114,10095,217,4733,3,2,78,0,0,2,0
Bacteroides_caccae_53434,700035533,700172393,162,3197893,456672,2082713,37,80,387,1651,17,2,456285,2081062,20,78,312944,5920150,10092,217,4733,3,2,76,0,0,2,0
Bacteroides_caccae_53434,700035533,700172498,531,3191456,455725,2078565,183,181,17333,80738,159,83,438392,1997827,24,98,300102,5683710,9669,12393,229404,417,4,94,0,0,83,0
Bacteroides_caccae_53434,700035533,700173546,545,3195317,456278,2081020,194,172,17333,80752,159,81,438945,2000268,35,91,300510,5690625,9669,12399,229440,417,4,87,0,0,81,0
Bacteroides_caccae_53434,700035533,ERR912014,181,3173273,453450,2066741,42,92,387,1655,17,2,453063,2065086,25,90,310309,5874938,10011,219,4743,3,3,87,0,0,2,0
Bacteroides_caccae_53434,700035533,ERR912100,634,3198940,456816,2083399,243,180,19619,88675,217,90,437197,1994724,26,90,299952,5674560,9660,13318,252275,432,3,87,0,1,89,0
Bacteroides_caccae_53434,700035533,ERR912124,554,3183953,454497,2073663,207,164,17476,79737,182,78,437021,1993926,25,86,299834,5672281,9663,12080,226738,393,2,84,0,0,78,0
Bacteroides_caccae_53434,700035533,ERR912164,190,3197461,456606,2082442,46,91,387,1655,17,2,456219,2080787,29,89,312922,5919350,10089,216,4743,6,2,87,0,0,2,0
Bacteroides_caccae_53434,700035861,700038386,459,3155529,449382,2055232,156,164,16629,77732,130,75,432753,1977500,26,89,297960,5625426,9114,12002,220801,393,3,86,0,0,75,0
Bacteroides_caccae_53434,700035861,700100600,459,3190778,455874,2078181,164,158,16315,76218,134,76,439559,2001963,30,82,300842,5695837,9210,11755,216503,396,2,80,0,0,76,0
Bacteroides_caccae_53434,700035861,700101243,468,3188271,455614,2076532,165,162,16873,78656,142,81,438741,1997876,23,81,300129,5684271,9228,12119,223450,399,1,80,0,0,81,0
Bacteroides_caccae_53434,700035861,700102659,1517,3186161,455629,2075181,556,423,50845,232131,538,350,404784,1843050,18,73,276707,5243932,8511,35148,660135,1110,0,73,0,1,349,0
Bacteroides_caccae_53434,700035861,700111156,841,3194664,456668,2080709,291,273,26502,121348,258,166,430166,1959361,33,107,294744,5574228,9111,18080,345436,528,3,104,0,0,166,0
Bacteroides_caccae_53434,700035861,700114480,469,3172354,452743,2066176,161,165,16282,76088,131,75,436461,1990088,30,90,299316,5661807,9141,11730,216141,393,1,89,0,0,75,0
Bacteroides_caccae_53434,700035861,700161872,677,3194805,456693,2080774,274,193,27150,121323,254,123,429543,1959451,20,70,294885,5574429,9039,17969,345391,609,1,69,0,1,122,0
Bacteroides_caccae_53434,700035861,700161967,890,3196847,456959,2082127,336,260,31166,140617,319,162,425793,1941510,17,98,292277,5523238,9015,20795,400417,639,1,97,0,1,161,0
Bacteroides_caccae_53434,700035861,700172498,469,3190960,456149,2078316,158,170,16400,76486,135,78,439749,2001830,23,92,300630,5695599,9261,11785,217277,396,2,90,0,0,78,0
Bacteroides_caccae_53434,700035861,700173546,484,3196963,457037,2082176,171,159,16398,76473,135,76,440639,2005703,36,83,301254,5706588,9267,11782,217241,396,2,81,0,0,76,0
Bacteroides_caccae_53434,700035861,ERR912100,573,3198043,457151,2082912,222,166,19364,87564,204,90,437787,1995348,18,76,299974,5676851,9219,13193,249061,438,1,75,0,1,89,0
Bacteroides_caccae_53434,700035861,ERR912124,498,3184720,455084,2074252,186,154,17169,78389,167,78,437915,1995863,19,76,300065,5678290,9234,11931,222840,396,0,76,0,0,78,0
Bacteroides_caccae_53434,700037008,ERR912173,3389,3188735,455320,2076674,1215,884,160088,727732,1190,753,295232,1348942,25,131,203637,3836592,6597,108672,2070969,3555,1,130,0,4,749,0
Bacteroides_caccae_53434,700037090,700038386,454,3166223,450345,2062156,153,157,17199,80478,137,78,433146,1981678,16,79,298724,5636749,9561,12409,228614,411,5,74,0,0,78,0
Bacteroides_caccae_53434,700037090,700100600,455,3201402,456874,2085066,161,151,16993,79375,142,80,439881,2005691,19,71,301505,5705929,9639,12221,225484,420,4,67,0,0,80,0
Bacteroides_caccae_53434,700037090,700101243,469,3199110,456667,2083578,163,159,16962,79198,142,79,439705,2004380,21,80,301193,5702299,9648,12201,224979,414,3,77,0,0,79,0
Bacteroides_caccae_53434,700037090,700102659,1505,3196226,456674,2081683,550,417,50978,232938,535,350,405696,1848745,15,67,277633,5259722,8880,35276,662401,1137,2,65,0,1,349,0
Bacteroides_caccae_53434,700037090,700111156,839,3206241,457805,2088221,287,270,26552,121680,258,175,431253,1966541,29,95,295919,5594125,9579,18127,346358,555,5,90,0,0,175,0
Bacteroides_caccae_53434,700037090,700114480,467,3183080,453705,2073134,158,161,16856,78811,138,78,436849,1994323,20,83,300067,5673302,9600,12138,223884,411,3,80,0,0,78,0
Bacteroides_caccae_53434,700037090,700161872,674,3206581,457855,2088404,270,188,27211,121696,253,122,430644,1966708,17,66,296064,5594550,9510,18027,346428,633,3,63,0,1,121,0
Bacteroides_caccae_53434,700037090,700161967,881,3208559,458096,2089727,331,250,31313,141548,317,160,426783,1948179,14,90,293354,5541703,9480,20955,403020,669,3,87,0,1,159,0
Bacteroides_caccae_53434,700037090,700172498,469,3202746,457321,2085959,155,169,16970,79176,142,81,440351,2006783,13,88,301474,5709143,9732,12188,224926,414,4,84,0,0,81,0
Bacteroides_caccae_53434,700037090,700173546,483,3208840,458201,2089873,168,155,16975,79203,142,79,441226,2010670,26,76,302099,5720176,9735,12193,225002,414,3,73,0,0,79,0
Bacteroides_caccae_53434,700037090,ERR912100,571,3209808,458317,2090531,218,162,19333,87415,203,87,438984,2003116,15,75,301249,5698376,9723,13163,248653,429,3,72,0,1,86,0
Bacteroides_caccae_53434,700037090,ERR912124,491,3196423,456230,2081837,182,146,16433,74910,166,73,439797,2006927,16,73,301886,5709163,9732,11357,212989,384,2,71,0,0,73,0
Bacteroides_caccae_53434,700037090,ERR912164,129,3208338,458101,2089586,19,82,50,235,3,0,458051,2089351,16,82,314246,5943646,10161,38,667,0,2,80,0,0,0,0
Bacteroides_caccae_53434,700037405,700037852,983,3197166,456356,2082306,321,313,26612,119195,288,181,429744,1963111,33,132,295745,5584126,9462,17517,339456,612,5,127,0,0,181,0
Bacteroides_caccae_53434,700037405,700038072,843,3197075,456653,2082291,311,220,27716,124550,285,130,428937,1957741,26,90,294349,5569349,9525,18757,354347,546,7,82,1,2,128,0
Bacteroides_caccae_53434,700037405,700095058,1056,3193999,456362,2080273,371,314,34092,154080,346,208,422270,1926193,25,106,289866,5479557,9156,22866,438597,777,5,101,0,1,207,0
Bacteroides_caccae_53434,700037405,700113114,979,3204822,457761,2087258,379,239,33244,149585,347,144,424517,1937673,32,95,291497,5512123,9399,22352,425698,705,5,90,0,3,141,0
Bacteroides_caccae_53434,700037405,700114218,997,3202096,457436,2085481,333,312,25691,114693,289,183,431745,1970788,44,129,296802,5606073,9489,16779,326721,579,4,125,0,0,183,0
Bacteroides_caccae_53434,700037405,ERR912168,1203,3204678,457729,2087162,440,339,43290,196553,402,231,414439,1890609,38,108,284777,5377900,9150,29075,559660,924,4,104,0,1,230,0
Bacteroides_caccae_53434,700037632,700038702,454,3201150,456755,2084773,136,164,8846,41420,106,55,447909,2043353,30,109,307218,5812881,9960,6471,117588,201,9,100,0,0,55,0
Bacteroides_caccae_53434,700037632,700103477,461,3201113,456742,2084756,134,166,8865,41529,106,55,447877,2043227,28,111,307207,5812517,9957,6492,117891,204,7,104,0,0,55,0
Bacteroides_caccae_53434,700037632,700105613,209,3201764,456835,2085176,58,82,1207,5623,33,4,455628,2079553,25,78,312855,5915649,10155,900,15957,12,8,70,0,0,4,0
Bacteroides_caccae_53434,700037632,700108218,483,3201176,456733,2084792,134,195,8746,40940,100,53,447987,2043852,34,142,307309,5814284,9963,6390,116226,204,10,132,0,0,53,0
Bacteroides_caccae_53434,700037632,700116730,543,3200902,456717,2084620,138,220,8746,40940,101,55,447971,2043680,37,165,307268,5813833,9939,6389,116227,204,7,158,0,0,55,0
Bacteroides_caccae_53434,700037632,700161429,213,3198474,456368,2083067,54,94,1207,5624,33,5,455161,2077443,21,89,312529,5909711,10089,901,15959,12,11,78,0,1,4,0
Bacteroides_caccae_53434,700037632,ERR912052,215,3203511,457086,2086309,57,89,1207,5619,33,4,455879,2080690,24,85,313032,5918889,10149,898,15947,12,10,75,0,0,4,0
Bacteroides_caccae_53434,700037632,ERR912071,197,3202674,456958,2085789,55,79,1207,5624,33,4,455751,2080165,22,75,312969,5917398,10128,901,15959,12,8,67,0,0,4,0
Bacteroides_caccae_53434,700037632,ERR912087,534,3203129,457039,2086077,148,214,8247,38454,99,44,448792,2047623,49,170,307941,5824959,9969,5958,109215,189,8,162,0,0,44,0
Bacteroides_caccae_53434,700037632,ERR912107,551,3191527,455450,2078486,145,227,8746,40941,100,55,446704,2037545,45,172,306364,5796332,9939,6389,116230,204,9,163,0,1,54,0
Bacteroides_caccae_53434,700037632,ERR912117,547,3204372,457196,2086891,141,225,8247,38462,99,44,448949,2048429,42,181,308060,5827258,9969,5960,109237,189,6,175,0,0,44,0
Bacteroides_caccae_53434,700037632,ERR912122,560,3203057,457018,2086028,149,227,8257,38521,103,44,448761,2047507,46,183,307918,5824643,9960,5970,109404,189,11,172,0,0,44,0
Bacteroides_caccae_53434,700037632,ERR912144,560,3204405,457209,2086905,149,230,8746,40942,100,55,448463,2045963,49,175,307625,5820298,9966,6390,116232,204,9,166,0,1,54,0
Bacteroides_caccae_53434,700037632,ERR912148,453,3203842,457114,2086524,133,168,8736,40912,101,55,448378,2045612,32,113,307602,5819286,9948,6386,116146,204,7,106,0,1,54,0
Bacteroides_caccae_53434,700037632,ERR912178,543,3204527,457243,2086982,142,216,8746,40942,100,54,448497,2046040,42,162,307627,5820545,9948,6390,116232,204,8,154,0,0,54,0
Bacteroides_caccae_53434,700037632,ERR912189,544,3204689,457251,2087093,143,222,8247,38453,100,45,449004,2048640,43,177,308086,5827850,9984,5959,109211,189,11,166,0,0,45,0
Bacteroides_caccae_53434,700037649,700105685,1129,3154614,450825,2054531,372,364,43022,197190,341,221,407803,1857341,31,143,279039,5284020,8964,29850,560733,987,4,139,0,2,219,0
Bacteroides_caccae_53434,700037738,ERR912011,256,3215128,458877,2093930,46,148,1558,6121,13,6,457319,2087809,33,142,314316,5938950,10161,772,17543,48,9,133,0,0,6,0
Bacteroides_caccae_53434,700037852,700038072,1394,3190089,455378,2077759,493,384,41376,185976,447,248,414002,1891783,46,136,284974,5381198,9177,27586,529466,876,5,130,1,2,246,0
Bacteroides_caccae_53434,700037852,700095058,247,3187396,455137,2076010,66,114,3533,17057,52,26,451604,2058953,14,88,309491,5857528,9840,2752,48341,78,2,86,0,1,25,0
Bacteroides_caccae_53434,700037852,700113114,1450,3197411,456404,2082466,523,393,53196,239971,490,274,403208,1842495,33,119,277831,5240744,8910,35448,683298,1167,2,117,0,3,271,0
Bacteroides_caccae_53434,700037852,ERR912168,461,3197411,456384,2082464,141,171,11958,56080,122,83,444426,2026384,19,88,304798,5764535,9819,8493,159501,246,1,87,0,0,83,0
Bacteroides_caccae_53434,700038072,700095058,1466,3187802,455497,2076309,546,381,45542,205191,511,271,409955,1871118,35,110,281627,5322790,8937,30489,584115,969,4,105,1,4,267,0
Bacteroides_caccae_53434,700038072,700113114,350,3198252,456844,2083047,131,109,12334,56467,112,35,444510,2026580,19,74,304891,5765054,9795,8315,160810,276,5,68,1,1,34,0
Bacteroides_caccae_53434,700038072,700114218,1417,3198039,456865,2082938,512,383,43177,193456,461,256,413688,1889482,51,127,284576,5374744,9126,28575,550863,930,4,122,1,2,254,0
Bacteroides_caccae_53434,700038072,ERR912168,1613,3202296,457401,2085685,614,407,53207,240840,565,300,404194,1844845,49,107,277874,5247706,8955,35762,685651,1107,4,102,1,2,298,0
Bacteroides_caccae_53434,700038386,700102586,468,3165113,450169,2061414,159,161,17191,80453,134,79,432978,1980961,25,82,298593,5634723,9567,12411,228537,411,4,77,1,1,78,0
Bacteroides_caccae_53434,700038386,700102659,1543,3151699,448532,2052696,575,428,49045,225354,549,345,399487,1827342,26,83,275305,5198024,8697,34210,640718,1134,2,81,0,2,343,0
Bacteroides_caccae_53434,700038386,700105049,454,3161165,449599,2058834,152,157,17188,80449,137,77,432411,1978385,15,80,298209,5627388,9558,12405,228531,411,5,75,0,0,77,0
Bacteroides_caccae_53434,700038386,700106836,477,3163900,450003,2060642,158,172,16689,78161,127,75,433314,1982481,31,97,298795,5639069,9579,12067,222014,402,4,93,0,0,75,0
Bacteroides_caccae_53434,700038386,700111156,1176,3161756,449686,2059266,422,356,43235,200227,387,256,406451,1859039,35,100,280333,5287784,9000,30323,569410,948,5,95,0,1,255,0
Bacteroides_caccae_53434,700038386,700113867,466,3160540,449532,2058411,158,161,17176,80355,138,80,432356,1978056,20,81,298152,5626473,9543,12380,228274,411,3,78,0,0,80,0
Bacteroides_caccae_53434,700038386,700116296,446,3160394,449528,2058325,153,153,17185,80360,137,77,432343,1977965,16,76,298124,5626216,9555,12381,228288,411,3,73,0,0,77,0
Bacteroides_caccae_53434,700038386,700161743,430,3161478,449597,2059032,152,139,16685,78148,129,71,432912,1980884,23,68,298599,5634507,9546,12065,221977,402,4,64,0,0,71,0
Bacteroides_caccae_53434,700038386,700161872,720,3161864,449685,2059297,284,210,23773,108974,259,131,425912,1950323,25,79,294104,5547430,9435,16595,309802,525,4,75,0,1,130,0
Bacteroides_caccae_53434,700038386,700161967,641,3164281,450012,2060890,233,207,21234,96494,223,106,428778,1964396,10,101,296609,5587015,9564,14330,274753,399,4,97,0,1,105,0
Bacteroides_caccae_53434,700038386,700171859,468,3161685,449677,2059185,158,163,17191,80452,137,79,432486,1978733,21,84,298276,5628356,9567,12402,228543,411,4,80,0,0,79,0
Bacteroides_caccae_53434,700038386,700172279,478,3162532,449818,2059737,152,176,17199,80488,138,80,432619,1979249,14,96,298324,5629865,9558,12414,228639,411,3,93,0,0,80,0
Bacteroides_caccae_53434,700038386,700172393,482,3161137,449602,2058801,157,176,16687,78162,130,75,432915,1980639,27,101,298549,5633795,9573,12067,222017,402,3,98,0,0,75,0
Bacteroides_caccae_53434,700038386,700173546,111,3164095,450029,2060741,23,58,50,249,3,0,449979,2060492,20,58,310856,5860648,9972,34,707,6,5,53,0,0,0,0
Bacteroides_caccae_53434,700038386,ERR912014,418,3143501,447404,2047403,138,142,14580,67282,120,66,432824,1980121,18,76,298447,5632361,9555,10225,191273,348,4,72,0,0,66,0
Bacteroides_caccae_53434,700038386,ERR912100,333,3165411,450195,2061624,123,117,9422,42959,110,38,440773,2018665,13,79,304432,5741759,9804,6598,122111,168,4,75,0,1,37,0
Bacteroides_caccae_53434,700038386,ERR912124,252,3152461,448183,2053209,86,101,7202,33619,73,27,440981,2019590,13,74,304600,5744351,9819,5290,95438,129,3,71,0,0,27,0
Bacteroides_caccae_53434,700038386,ERR912164,478,3163674,449941,2060507,160,168,17234,80669,141,81,432707,1979838,19,87,298438,5631518,9558,12450,229146,411,3,84,0,0,81,0
Bacteroides_caccae_53434,700038472,700114082,881,3206270,457389,2088170,315,250,30393,136169,282,138,426996,1952001,33,112,294639,5551857,9507,19715,388111,681,4,108,0,0,138,0
Bacteroides_caccae_53434,700038472,SRR413615,2852,3211232,458306,2091464,1088,725,130934,597526,1055,613,327372,1493938,33,112,225761,4248931,7122,88898,1700650,3030,1,111,0,1,612,0
Bacteroides_caccae_53434,700038702,700103477,186,3212305,458691,2092083,30,111,179,888,10,4,458512,2091195,20,107,314469,5948919,10197,153,2505,6,4,103,0,0,4,0
Bacteroides_caccae_53434,700038702,700105613,376,3213155,458832,2092631,99,163,7649,35804,73,49,451183,2056827,26,114,309134,5851342,10005,5568,101652,192,7,107,0,0,49,0
Bacteroides_caccae_53434,700038702,700108218,215,3212621,458738,2092288,37,134,90,440,6,0,458648,2091848,31,134,314573,5950774,10197,71,1249,0,7,127,0,0,0,0
Bacteroides_caccae_53434,700038702,700116730,276,3211757,458642,2091721,37,164,90,449,6,1,458552,2091272,31,163,314445,5949192,10179,74,1273,0,4,159,0,0,1,0
Bacteroides_caccae_53434,700038702,700161429,379,3207567,458019,2089019,95,175,7639,35784,73,49,450380,2053235,22,126,308586,5841186,9933,5564,101596,192,11,115,0,0,49,0
Bacteroides_caccae_53434,700038702,ERR912052,376,3212839,458784,2092419,98,166,7559,35370,67,49,451225,2057049,31,117,309163,5851982,10002,5499,100419,192,9,108,0,0,49,0
Bacteroides_caccae_53434,700038702,ERR912071,361,3211854,458652,2091795,94,160,7649,35816,74,49,451003,2055979,20,111,309024,5848944,9969,5567,101689,192,7,104,0,0,49,0
Bacteroides_caccae_53434,700038702,ERR912107,286,3200953,457151,2084661,45,171,90,440,6,1,457061,2084221,39,170,313436,5929054,10173,71,1249,0,8,162,0,0,1,0
Bacteroides_caccae_53434,700038702,ERR912117,281,3213833,458906,2093082,41,168,90,440,6,1,458816,2092642,35,167,314707,5953025,10194,71,1249,0,3,164,0,0,1,0
Bacteroides_caccae_53434,700038702,ERR912148,154,3213290,458834,2092701,29,91,90,447,6,0,458744,2092254,23,91,314672,5951905,10185,70,1271,0,5,86,0,0,0,0
Bacteroides_caccae_53434,700038702,ERR912178,281,3214017,458954,2093195,43,162,90,440,6,1,458864,2092755,37,161,314700,5953380,10185,71,1249,0,5,156,0,0,1,0
Bacteroides_caccae_53434,700038702,ERR912189,281,3214061,458952,2093228,44,168,90,440,6,1,458862,2092788,38,167,314714,5953447,10203,71,1249,0,8,159,0,0,1,0
Bacteroides_caccae_53434,700038806,700106754,299,3199982,456979,2084064,64,145,4378,20625,42,29,452601,2063439,22,116,310228,5870057,10032,3179,58606,90,4,112,0,0,29,0
Bacteroides_caccae_53434,700038806,ERR912136,362,3193538,456177,2079902,99,151,6856,31159,74,36,449321,2048743,25,115,308028,5828271,9930,4735,88577,165,4,111,0,0,36,0
Bacteroides_caccae_53434,700038806,ERR912162,1018,3201835,457235,2085279,369,266,35773,161861,339,168,421462,1923418,30,98,289374,5471466,9414,24273,460596,714,0,98,0,0,168,0
Bacteroides_caccae_53434,700095058,700113114,1480,3195615,456610,2081323,552,381,56197,253587,521,284,400413,1827736,31,97,275409,5199114,8685,37468,722051,1242,2,95,0,2,282,0
Bacteroides_caccae_53434,700095058,700114218,253,3193261,456334,2079804,79,108,3534,17061,51,26,452800,2062743,28,82,309871,5868536,9822,2753,48352,78,1,81,0,1,25,0
Bacteroides_caccae_53434,700095058,ERR912168,545,3196258,456679,2081754,195,176,15542,73162,174,112,441137,2008592,21,64,301726,5714438,9612,11236,207944,306,1,63,0,1,111,0
Bacteroides_caccae_53434,700096865,700114000,989,3182168,454848,2072503,362,308,28789,126362,310,158,426059,1946141,52,150,293309,5535769,9345,18014,360460,612,2,148,0,3,155,0
Bacteroides_caccae_53434,700096865,pluto3-11-30-0_,883,3185837,455398,2074916,322,282,19783,87578,269,126,435615,1987338,53,156,299063,5653390,9561,12623,249730,381,4,152,0,2,124,0
Bacteroides_caccae_53434,700097291,700171648,1403,3163937,451665,2060592,480,386,68050,308401,449,269,383615,1752191,31,117,264997,4983329,8247,44990,878623,1590,1,116,0,0,269,0
Bacteroides_caccae_53434,700097291,ERR911970,148,3178401,454354,2070088,26,87,482,2201,6,0,453872,2067887,20,87,310598,5883226,9837,308,6271,24,3,84,0,0,0,0
Bacteroides_caccae_53434,700097291,ERR912037,4154,3176528,454132,2068889,1559,1079,165795,752344,1531,975,288337,1316545,28,104,198402,3744975,6258,112298,2141164,3570,0,103,1,4,970,1
Bacteroides_caccae_53434,700097291,SRR2822459,126,3176788,454135,2069022,22,84,80,399,5,0,454055,2068623,17,84,310668,5885367,9834,67,1130,0,3,81,0,0,0,0
Bacteroides_caccae_53434,700099886,700116668,3257,3206963,458089,2088652,1230,809,127115,578930,1181,696,330974,1509722,49,113,227605,4294430,7131,86448,1647492,2850,1,112,0,3,693,0
Bacteroides_caccae_53434,700099886,ERR912059,3164,3202737,457449,2085966,1171,802,126640,575485,1132,699,330809,1510481,39,103,228149,4296148,7146,85481,1638154,2820,3,100,0,4,695,0
Bacteroides_caccae_53434,700099886,ERR912175,3292,3208379,458262,2089574,1237,822,128653,585944,1194,706,329609,1503630,43,116,226695,4277091,7104,87512,1667425,2895,1,115,0,2,704,0
Bacteroides_caccae_53434,700100022,700117682,665,3167489,452348,2062860,251,170,18913,84004,237,108,433435,1978856,14,62,297782,5629072,9714,12370,239249,393,2,60,0,0,108,0
Bacteroides_caccae_53434,700100600,700102586,471,3202680,457061,2085883,169,154,16966,79261,139,81,440095,2006622,30,73,301642,5708570,9654,12200,225169,414,3,69,1,1,80,0
Bacteroides_caccae_53434,700100600,700102659,1551,3191422,455733,2078565,584,421,49974,228956,562,356,405759,1849609,22,65,277903,5262104,8820,34679,651070,1119,2,63,0,1,355,0
Bacteroides_caccae_53434,700100600,700105049,457,3200294,456712,2084313,162,150,16981,79325,142,79,439731,2004988,20,71,301433,5703880,9651,12208,225353,414,4,67,0,0,79,0
Bacteroides_caccae_53434,700100600,700106836,479,3200782,456755,2084658,169,165,16973,79269,140,84,439782,2005389,29,81,301472,5705038,9657,12201,225192,414,3,78,0,0,84,0
Bacteroides_caccae_53434,700100600,700111156,1192,3198408,456411,2083128,436,351,43456,200666,399,256,412955,1882462,37,95,283151,5355154,9081,30293,570739,966,5,90,0,0,256,0
Bacteroides_caccae_53434,700100600,700113867,468,3200159,456730,2084222,166,155,16970,79246,143,82,439760,2004976,23,73,301388,5703913,9627,12194,225130,414,2,71,0,0,82,0
Bacteroides_caccae_53434,700100600,700116296,449,3199683,456653,2083921,163,147,16974,79231,142,79,439679,2004690,21,68,301370,5703049,9651,12188,225091,414,2,66,0,0,79,0
Bacteroides_caccae_53434,700100600,700161743,431,3200219,456644,2084265,162,131,16989,79353,142,79,439655,2004912,20,52,301418,5703697,9621,12217,225422,420,3,49,0,0,79,0
Bacteroides_caccae_53434,700100600,700161872,721,3201249,456864,2084945,291,203,23249,106372,263,130,433615,1978573,28,73,297543,5628645,9531,16177,302417,522,3,70,0,1,129,0
Bacteroides_caccae_53434,700100600,700161967,630,3203435,457144,2086400,234,200,21234,96027,220,112,435910,1990373,14,88,299754,5661705,9660,14192,273487,402,3,85,0,1,111,0
Bacteroides_caccae_53434,700100600,700171859,474,3198593,456458,2083222,169,158,16975,79300,142,81,439483,2003922,27,77,301250,5700868,9648,12209,225277,414,3,74,0,0,81,0
Bacteroides_caccae_53434,700100600,700172279,481,3201929,456983,2085380,162,169,16983,79324,143,82,440000,2006056,19,87,301556,5706967,9645,12207,225351,414,2,85,0,0,82,0
Bacteroides_caccae_53434,700100600,700172393,484,3200402,456747,2084384,166,169,17001,79416,143,83,439746,2004968,23,86,301408,5703857,9639,12223,225605,420,2,84,0,0,83,0
Bacteroides_caccae_53434,700100600,ERR912014,427,3178459,453886,2070177,147,140,14370,66148,125,68,439516,2004029,22,72,301234,5701217,9636,10026,188067,351,3,69,0,0,68,0
Bacteroides_caccae_53434,700100600,ERR912100,329,3204340,457294,2086978,126,110,9205,41788,110,41,448089,2045190,16,69,307615,5818061,9894,6387,118800,177,3,66,0,1,40,0
Bacteroides_caccae_53434,700100600,ERR912124,250,3189095,454941,2077084,91,94,6912,32176,73,28,448029,2044908,18,66,307584,5817234,9906,5054,91339,135,2,64,0,0,28,0
Bacteroides_caccae_53434,700100600,ERR912164,481,3202684,457069,2085902,170,161,17051,79670,147,82,440018,2006232,23,79,301598,5707441,9657,12271,226325,414,2,77,0,0,82,0
Bacteroides_caccae_53434,700101243,700102586,482,3200526,456871,2084472,170,160,16933,79072,139,80,439938,2005400,31,80,301338,5705205,9657,12181,224621,414,2,77,1,1,79,0
Bacteroides_caccae_53434,700101243,700102659,1561,3189051,455514,2077018,584,432,49791,228096,560,359,405723,1848922,24,73,277707,5260221,8838,34550,648625,1113,1,72,0,1,358,0
Bacteroides_caccae_53434,700101243,700105049,472,3200968,456934,2084764,162,161,16936,79078,142,78,439998,2005686,20,83,301394,5706004,9660,12180,224640,414,3,80,0,0,78,0
Bacteroides_caccae_53434,700101243,700106836,489,3198185,456525,2082963,168,172,16939,79066,140,83,439586,2003897,28,89,301123,5700911,9657,12175,224609,414,2,87,0,0,83,0
Bacteroides_caccae_53434,700101243,700111156,1207,3195991,456177,2081555,438,359,43415,200545,398,258,412762,1881010,40,101,282828,5351127,9075,30276,570390,969,4,97,0,0,258,0
Bacteroides_caccae_53434,700101243,700113867,476,3200532,456922,2084462,167,160,16942,79061,143,81,439980,2005401,24,79,301332,5705229,9642,12171,224598,414,1,78,0,0,81,0
Bacteroides_caccae_53434,700101243,700116296,456,3200134,456852,2084224,162,153,16439,76752,134,72,440413,2007472,28,81,301662,5711088,9666,11822,218029,405,1,80,0,0,72,0
Bacteroides_caccae_53434,700101243,700161743,444,3200762,456842,2084629,162,140,16443,76826,134,72,440399,2007803,28,68,301742,5712013,9654,11844,218229,405,2,66,0,0,72,0
Bacteroides_caccae_53434,700101243,700161872,728,3201251,456992,2084960,291,209,23600,107853,263,133,433392,1977107,28,76,297218,5624575,9528,16384,306644,531,2,74,0,1,132,0
Bacteroides_caccae_53434,700101243,700161967,646,3201501,456996,2085127,237,209,21004,95130,222,114,435992,1989997,15,95,299567,5660758,9666,14061,270936,393,2,93,0,1,113,0
Bacteroides_caccae_53434,700101243,700171859,486,3198544,456611,2083192,168,167,16942,79103,142,80,439669,2004089,26,87,301143,5701470,9654,12183,224712,414,2,85,0,0,80,0
Bacteroides_caccae_53434,700101243,700172279,493,3201984,457129,2085441,162,177,16947,79123,143,81,440182,2006318,19,96,301468,5707826,9660,12184,224771,414,1,95,0,0,81,0
Bacteroides_caccae_53434,700101243,700172393,497,3200878,456946,2084691,167,178,16941,79097,143,82,440005,2005594,24,96,301388,5705734,9660,12179,224698,414,1,95,0,0,82,0
Bacteroides_caccae_53434,700101243,ERR912014,437,3176406,453739,2068837,148,148,14334,65942,125,67,439405,2002895,23,81,300945,5698107,9633,9993,187482,351,2,79,0,0,67,0
Bacteroides_caccae_53434,700101243,ERR912100,337,3202259,457122,2085615,126,118,9059,41177,108,41,448063,2044438,18,77,307381,5816033,9900,6303,117057,171,2,75,0,1,40,0
Bacteroides_caccae_53434,700101243,ERR912124,260,3187137,454788,2075797,90,102,6787,31664,72,28,448001,2044133,18,74,307326,5815167,9906,4998,89865,129,1,73,0,0,28,0
Bacteroides_caccae_53434,700101243,ERR912164,489,3200594,456901,2084535,170,166,16930,79061,143,82,439971,2005474,27,84,301353,5705415,9654,12184,224585,414,1,83,0,0,82,0
Bacteroides_caccae_53434,700102586,700102659,1532,3197159,456794,2082283,561,426,50940,232820,536,351,405854,1849463,25,75,277740,5261769,8880,35264,662059,1137,2,72,1,1,350,0
Bacteroides_caccae_53434,700102586,700111156,868,3204749,457558,2087227,297,279,26558,121691,257,175,431000,1965536,40,104,295777,5591252,9579,18123,346395,555,5,98,1,0,175,0
Bacteroides_caccae_53434,700102586,700114480,482,3184439,453904,2073992,166,164,16487,77121,131,73,437417,1996871,35,91,300435,5680560,9618,11895,219063,405,3,87,1,0,73,0
Bacteroides_caccae_53434,700102586,700161872,691,3207514,457989,2089001,279,190,29246,130794,258,125,428743,1958207,21,65,294772,5570375,9474,19404,372312,666,2,62,1,2,123,0
Bacteroides_caccae_53434,700102586,700161967,900,3209415,458219,2090261,338,259,31288,141463,313,157,426931,1948798,25,102,293427,5543481,9486,20955,402765,669,3,98,1,1,156,0
Bacteroides_caccae_53434,700102586,700172498,482,3200912,457019,2084758,163,167,16952,79133,139,82,440067,2005625,24,85,301288,5705861,9726,12187,224798,414,3,81,1,1,81,0
Bacteroides_caccae_53434,700102586,700173546,501,3207126,457919,2088752,176,160,16445,76826,131,73,441474,2011926,45,87,302281,5723753,9744,11843,218230,405,4,82,1,0,73,0
Bacteroides_caccae_53434,700102586,ERR912100,588,3210780,458461,2091142,224,169,19309,87331,200,85,439152,2003811,24,84,301340,5700358,9735,13149,248415,429,3,80,1,1,84,0
Bacteroides_caccae_53434,700102586,ERR912124,508,3196699,456268,2082001,188,153,16423,74870,163,71,439845,2007131,25,82,301894,5709764,9735,11354,212872,384,2,79,1,0,71,0
Bacteroides_caccae_53434,700102659,700105049,1510,3194897,456468,2080798,552,417,50820,232298,537,348,405648,1848500,15,69,277620,5258997,8883,35183,660580,1131,2,67,0,1,347,0
Bacteroides_caccae_53434,700102659,700106836,1546,3195310,456506,2081094,563,435,50951,232845,539,354,405555,1848249,24,81,277561,5258306,8880,35266,662132,1137,1,80,0,1,353,0
Bacteroides_caccae_53434,700102659,700111156,2241,3192900,456166,2079543,825,613,77484,354429,796,526,378682,1725114,29,87,259224,4907817,8301,53369,1008232,1686,3,84,0,1,525,0
Bacteroides_caccae_53434,700102659,700113867,1516,3195023,456537,2080870,556,418,50817,232237,540,351,405720,1848633,16,67,277614,5259411,8874,35168,660412,1131,0,67,0,1,350,0
Bacteroides_caccae_53434,700102659,700114480,1555,3173102,452586,2066630,578,432,49550,227261,554,349,403036,1839369,24,83,276622,5232722,8763,34449,646221,1113,0,83,0,2,347,0
Bacteroides_caccae_53434,700102659,700116296,1497,3194780,456491,2080718,550,413,50819,232219,533,346,405672,1848499,17,67,277597,5259017,8883,35169,660357,1131,0,67,0,1,345,0
Bacteroides_caccae_53434,700102659,700161743,1491,3194578,456344,2080607,554,401,50834,232369,538,345,405510,1848238,16,56,277604,5258254,8856,35188,660788,1131,1,55,0,1,344,0
Bacteroides_caccae_53434,700102659,700161872,1453,3195944,456641,2081474,560,393,47016,213756,542,318,409625,1867718,18,75,280744,5313401,9009,32139,608115,1014,1,74,0,0,318,0
Bacteroides_caccae_53434,700102659,700161967,1954,3197863,456878,2082756,735,526,65670,298462,717,434,391208,1784294,18,92,268495,5075777,8610,44604,849375,1407,1,91,0,2,432,0
Bacteroides_caccae_53434,700102659,700171859,1528,3193139,456231,2079654,559,423,50843,232360,539,354,405388,1847294,20,69,277419,5255580,8883,35187,660762,1131,0,69,0,2,352,0
Bacteroides_caccae_53434,700102659,700172279,1541,3196620,456782,2081912,554,439,50843,232359,539,350,405939,1849553,15,89,277748,5262022,8889,35187,660759,1131,0,89,0,1,349,0
Bacteroides_caccae_53434,700102659,700172393,1544,3195027,456525,2080862,558,439,50830,232314,538,350,405695,1848548,20,89,277615,5259155,8874,35183,660628,1131,0,89,0,1,349,0
Bacteroides_caccae_53434,700102659,700172498,1565,3189155,455643,2077110,577,444,50968,233280,554,360,404675,1843830,23,84,276814,5245793,8883,35364,663342,1134,2,82,0,1,359,0
Bacteroides_caccae_53434,700102659,700173546,1582,3195322,456539,2081070,592,429,49995,228896,563,356,406544,1852174,29,73,278153,5269480,8889,34666,650903,1119,1,72,0,1,355,0
Bacteroides_caccae_53434,700102659,ERR912014,1453,3173247,453683,2066777,534,404,48356,219776,516,328,405327,1847001,18,76,277353,5254788,8862,33084,625167,1077,1,75,0,1,327,0
Bacteroides_caccae_53434,700102659,ERR912100,1637,3198950,457060,2083459,622,434,53812,244972,604,362,403248,1838487,18,72,276258,5230371,8832,36923,696808,1185,1,71,0,2,360,0
Bacteroides_caccae_53434,700102659,ERR912124,1562,3183582,454689,2073474,584,423,51477,235223,566,349,403212,1838251,18,74,276222,5229693,8838,35576,668950,1143,0,74,0,1,348,0
Bacteroides_caccae_53434,700102659,ERR912164,1538,3197392,456835,2082454,561,429,51000,233106,541,354,405835,1849348,20,75,277737,5261421,8886,35309,662872,1137,0,75,0,1,353,0
Bacteroides_caccae_53434,700103477,700105613,381,3213013,458813,2092539,97,163,7688,35981,73,51,451125,2056558,24,112,309088,5850581,10005,5605,102146,192,5,107,0,0,51,0
Bacteroides_caccae_53434,700103477,700108218,231,3212237,458664,2092026,38,141,129,630,7,2,458535,2091396,31,139,314518,5949470,10200,108,1782,0,5,134,0,0,2,0
Bacteroides_caccae_53434,700103477,700116730,286,3211324,458553,2091443,40,164,129,625,7,2,458424,2090818,33,162,314393,5947882,10179,108,1767,0,2,160,0,0,2,0
Bacteroides_caccae_53434,700103477,700161429,387,3207520,458003,2088981,93,178,7688,36010,73,51,450315,2052971,20,127,308535,5840436,9942,5605,102233,192,9,118,0,0,51,0
Bacteroides_caccae_53434,700103477,ERR912052,386,3213060,458811,2092556,96,170,7738,36253,76,53,451073,2056303,20,117,309047,5849866,9996,5651,102910,198,7,110,0,0,53,0
Bacteroides_caccae_53434,700103477,ERR912071,371,3211931,458652,2091836,93,164,7748,36304,77,53,450904,2055532,16,111,308942,5847691,9963,5661,103053,198,5,106,0,0,53,0
Bacteroides_caccae_53434,700103477,ERR912087,271,3213324,458846,2092742,47,162,129,625,7,2,458717,2092117,40,160,314612,5951542,10197,108,1767,0,3,157,0,0,2,0
Bacteroides_caccae_53434,700103477,ERR912107,299,3201007,457146,2084696,48,175,129,628,7,2,457017,2084068,41,173,313417,5928611,10176,109,1775,0,6,167,0,0,2,0
Bacteroides_caccae_53434,700103477,ERR912117,295,3214039,458923,2093202,43,173,189,935,10,4,458734,2092267,33,169,314644,5951966,10191,161,2638,6,1,168,0,0,4,0
Bacteroides_caccae_53434,700103477,ERR912122,304,3212805,458762,2092401,48,177,189,953,10,4,458573,2091448,38,173,314517,5949651,10176,163,2690,6,6,167,0,0,4,0
Bacteroides_caccae_53434,700103477,ERR912144,299,3214316,458979,2093380,48,177,129,625,7,2,458850,2092755,41,175,314714,5953354,10197,108,1767,0,5,170,0,0,2,0
Bacteroides_caccae_53434,700103477,ERR912148,196,3213356,458815,2092746,33,114,129,621,7,2,458686,2092125,26,112,314655,5951538,10182,108,1755,0,3,109,0,0,2,0
Bacteroides_caccae_53434,700103477,ERR912178,292,3214162,458973,2093286,44,165,129,626,7,2,458844,2092660,37,163,314690,5953102,10188,108,1770,0,3,160,0,0,2,0
Bacteroides_caccae_53434,700103477,ERR912189,291,3214232,458972,2093337,45,169,129,621,7,2,458843,2092716,38,167,314699,5953243,10206,108,1755,0,6,161,0,0,2,0
Bacteroides_caccae_53434,700105049,700111156,847,3202380,457216,2085673,287,274,26545,121660,257,173,430671,1964013,30,101,295578,5586885,9576,18121,346301,558,5,96,0,0,173,0
Bacteroides_caccae_53434,700105049,700114480,467,3184867,453974,2074265,159,158,16356,76556,130,71,437618,1997709,29,87,300582,5682921,9624,11799,217467,402,3,84,0,0,71,0
Bacteroides_caccae_53434,700105049,700161872,668,3207434,457977,2088950,268,184,27152,121467,252,120,430825,1967483,16,64,296189,5596747,9513,18000,345768,633,1,63,0,1,119,0
Bacteroides_caccae_53434,700105049,700161967,886,3207094,457891,2088736,330,256,31253,141335,316,160,426638,1947401,14,96,293226,5539494,9483,20936,402400,669,3,93,0,1,159,0
Bacteroides_caccae_53434,700105049,700172498,472,3200932,457022,2084764,156,169,16975,79232,142,80,440047,2005532,14,89,301310,5705551,9735,12193,225089,414,4,85,0,0,80,0
Bacteroides_caccae_53434,700105049,700173546,480,3204779,457577,2087203,167,151,16964,79181,142,78,440613,2008022,25,73,301723,5712611,9732,12189,224940,414,3,70,0,0,78,0
Bacteroides_caccae_53434,700105049,ERR912100,574,3208020,458057,2089332,218,165,18758,84510,198,81,439299,2004822,20,84,301575,5703150,9741,12658,240458,414,3,81,0,1,80,0
Bacteroides_caccae_53434,700105049,ERR912124,495,3192780,455707,2079427,181,150,16403,74801,166,71,439304,2004626,15,79,301517,5702629,9732,11343,212676,384,2,77,0,0,71,0
Bacteroides_caccae_53434,700105613,700108218,401,3213256,458843,2092693,98,189,7559,35364,67,49,451284,2057329,31,140,309204,5852778,10005,5497,100403,192,8,132,0,0,49,0
Bacteroides_caccae_53434,700105613,700116730,457,3212473,458745,2092187,102,213,7867,36748,69,52,450878,2055439,33,161,308923,5847413,9981,5666,104380,198,5,156,0,0,52,0
Bacteroides_caccae_53434,700105613,ERR912087,455,3213198,458850,2092661,111,212,7865,36740,69,51,450985,2055921,42,161,309047,5848726,9990,5664,104358,198,6,155,0,0,51,0
Bacteroides_caccae_53434,700105613,ERR912107,467,3201621,457253,2085097,109,220,7559,35364,67,50,449694,2049733,42,170,308073,5831145,9981,5497,100403,192,9,161,0,0,50,0
Bacteroides_caccae_53434,700105613,ERR912117,467,3214543,459017,2093542,105,221,7865,36747,69,51,451152,2056795,36,170,309184,5851211,9990,5666,104377,198,4,166,0,0,51,0
Bacteroides_caccae_53434,700105613,ERR912122,475,3213142,458834,2092619,113,223,7386,34365,72,41,451448,2058254,41,182,309446,5855320,9996,5252,97660,183,9,173,0,0,41,0
Bacteroides_caccae_53434,700105613,ERR912144,479,3214553,459037,2093539,113,225,7865,36740,69,52,451172,2056799,44,173,309161,5851234,10002,5664,104358,198,7,166,0,1,51,0
Bacteroides_caccae_53434,700105613,ERR912148,366,3213871,458916,2093076,94,160,7559,35376,68,51,451357,2057700,26,109,309300,5853810,9990,5499,100437,192,5,104,0,1,50,0
Bacteroides_caccae_53434,700105613,ERR912178,466,3214741,459075,2093663,106,214,7865,36740,69,51,451210,2056923,37,163,309174,5851608,9987,5664,104358,198,6,157,0,0,51,0
Bacteroides_caccae_53434,700105613,ERR912189,465,3214807,459069,2093708,107,220,7865,36740,70,51,451204,2056968,37,169,309192,5851707,10005,5664,104358,198,9,160,0,0,51,0
Bacteroides_caccae_53434,700106229,700114000,997,3209320,458288,2090150,368,313,28828,126575,308,156,429460,1963575,60,157,296315,5584873,9537,18041,361054,630,2,155,0,3,153,0
Bacteroides_caccae_53434,700106229,pluto3-11-30-0_,894,3213318,458881,2092774,328,292,21798,96389,272,133,437083,1996385,56,159,300884,5678554,9717,13865,274855,447,4,155,0,2,131,0
Bacteroides_caccae_53434,700106754,700113975,286,3185978,455044,2074981,68,139,4388,20677,42,29,450656,2054304,26,110,308900,5844034,9978,3189,58752,90,6,104,0,0,29,0
Bacteroides_caccae_53434,700106754,ERR912136,506,3199341,456992,2083703,140,204,11233,51727,115,63,445759,2031976,25,141,305387,5780644,9897,7894,147035,252,8,133,0,0,63,0
Bacteroides_caccae_53434,700106754,ERR912162,902,3206566,457874,2088395,320,235,31173,140277,292,137,426701,1948118,28,98,293138,5541658,9558,20916,399291,624,4,94,0,0,137,0
Bacteroides_caccae_53434,700106836,700111156,871,3205019,457601,2087426,295,288,26565,121774,257,173,431036,1965652,38,115,295799,5591569,9588,18135,346635,552,4,111,0,0,173,0
Bacteroides_caccae_53434,700106836,700114480,493,3182476,453614,2072731,165,177,16337,76449,128,75,437277,1996282,37,102,300345,5678880,9621,11789,217156,402,2,100,0,0,75,0
Bacteroides_caccae_53434,700106836,700161872,701,3205151,457624,2087474,278,203,27091,121076,252,124,430533,1966398,26,79,296066,5593606,9522,17885,344722,621,2,77,0,1,123,0
Bacteroides_caccae_53434,700106836,700161967,910,3207209,457881,2088844,337,272,31300,141504,315,163,426581,1947340,22,109,293225,5539318,9477,20948,402895,669,2,107,0,1,162,0
Bacteroides_caccae_53434,700106836,700172498,493,3201247,457087,2084983,162,182,16453,76848,132,78,440634,2008135,30,104,301664,5713000,9741,11848,218291,405,3,101,0,0,78,0
Bacteroides_caccae_53434,700106836,700173546,498,3207554,457989,2089041,171,165,17015,79418,143,83,440974,2009623,28,82,301945,5717186,9738,12226,225608,420,2,80,0,0,83,0
Bacteroides_caccae_53434,700106836,ERR912100,598,3208376,458088,2089599,225,181,19324,87371,201,90,438764,2002228,24,91,301114,5695844,9726,13151,248533,429,2,89,0,1,89,0
Bacteroides_caccae_53434,700106836,ERR912124,517,3193460,455768,2079914,187,165,16440,74922,164,76,439328,2004992,23,89,301566,5703666,9744,11358,213024,384,1,88,0,0,76,0
Bacteroides_caccae_53434,700106836,ERR912164,139,3206744,457840,2088543,24,85,50,235,3,0,457790,2088308,21,85,314091,5940675,10158,36,669,0,1,84,0,0,0,0
Bacteroides_caccae_53434,700108218,700161429,409,3207439,457974,2088942,94,204,7549,35347,67,49,450425,2053595,27,155,308625,5842227,9933,5495,100354,192,12,143,0,0,49,0
Bacteroides_caccae_53434,700108218,ERR912052,407,3212797,458763,2092401,99,195,7559,35370,67,49,451204,2057031,32,146,309169,5851928,9996,5499,100419,192,10,136,0,0,49,0
Bacteroides_caccae_53434,700108218,ERR912071,386,3211705,458595,2091701,95,184,7559,35379,68,49,451036,2056322,27,135,309075,5849916,9975,5498,100447,192,8,127,0,0,49,0
Bacteroides_caccae_53434,700108218,ERR912122,301,3212510,458713,2092213,44,193,80,371,5,0,458633,2091842,39,193,314589,5950749,10188,56,1057,0,9,184,0,0,0,0
Bacteroides_caccae_53434,700111156,700113867,847,3202308,457237,2085620,290,268,26547,121646,256,169,430690,1963974,34,99,295542,5586816,9564,18119,346264,555,3,96,0,0,169,0
Bacteroides_caccae_53434,700111156,700114480,1199,3180064,453260,2071170,430,365,43209,199742,392,256,410051,1871428,38,109,281729,5323522,9033,30185,568084,957,4,105,0,0,256,0
Bacteroides_caccae_53434,700111156,700116296,831,3201793,457169,2085290,288,265,26543,121626,257,169,430626,1963664,31,96,295495,5585918,9579,18121,346205,552,3,93,0,0,169,0
Bacteroides_caccae_53434,700111156,700161743,821,3201982,457065,2085437,289,253,26547,121677,259,170,430518,1963760,30,83,295552,5586185,9543,18131,346339,561,4,79,0,0,170,0
Bacteroides_caccae_53434,700111156,700161872,1414,3203196,457346,2086214,547,388,53777,243396,512,302,403569,1842818,35,86,277617,5241912,8925,36147,692856,1185,4,82,0,1,301,0
Bacteroides_caccae_53434,700111156,700161967,1628,3205373,457612,2087672,611,453,57749,262663,575,342,399863,1825009,36,111,274999,5191130,8898,38999,747763,1227,4,107,0,1,341,0
Bacteroides_caccae_53434,700111156,700171859,866,3203165,457358,2086204,295,282,26548,121653,258,174,430810,1964551,37,108,295646,5588428,9579,18119,346285,555,4,104,0,0,174,0
Bacteroides_caccae_53434,700111156,700172279,866,3203936,457467,2086700,288,290,26560,121734,260,171,430907,1964966,28,119,295691,5589634,9573,18134,346516,552,3,116,0,0,171,0
Bacteroides_caccae_53434,700111156,700172393,868,3202406,457230,2085687,291,288,26559,121703,261,171,430671,1963984,30,117,295555,5586827,9570,18131,346426,552,3,114,0,0,171,0
Bacteroides_caccae_53434,700111156,700172498,1204,3199240,456788,2083689,430,365,43533,200934,399,260,413255,1882755,31,105,282990,5356122,9153,30326,571507,969,4,101,0,1,259,0
Bacteroides_caccae_53434,700111156,700173546,1221,3205516,457694,2087736,444,357,43459,200507,404,262,414235,1887229,40,95,283708,5368814,9165,30254,570292,975,4,91,0,1,261,0
Bacteroides_caccae_53434,700111156,ERR912014,846,3183285,454816,2073328,289,270,26516,121525,258,172,428300,1951803,31,98,293478,5552427,9504,18104,345916,555,4,94,0,0,172,0
Bacteroides_caccae_53434,700111156,ERR912100,1308,3206320,457795,2088286,494,362,45890,209126,460,267,411905,1879160,34,95,282783,5345547,9150,31278,595110,990,4,91,0,1,266,0
Bacteroides_caccae_53434,700111156,ERR912124,1226,3191353,455475,2078546,460,341,43000,196650,425,248,412475,1881896,35,93,283233,5353290,9165,29479,559532,939,3,90,0,0,248,0
Bacteroides_caccae_53434,700111156,ERR912164,870,3204730,457542,2087257,297,280,26552,121674,262,171,430990,1965583,35,109,295819,5591351,9579,18120,346347,555,3,106,0,0,171,0
Bacteroides_caccae_53434,700112490,ERR912055,4550,3187549,455631,2076034,1762,1126,157240,714464,1722,987,298391,1361570,40,139,204991,3873110,6609,107082,2033070,3240,3,136,0,7,980,0
Bacteroides_caccae_53434,700113114,700114218,1470,3203529,457650,2086436,542,390,50272,225396,487,269,407378,1861040,55,121,280567,5293601,8952,33126,641952,1110,1,120,0,3,266,0
Bacteroides_caccae_53434,700113114,ERR912168,1642,3206486,457981,2088349,631,410,58786,266362,588,315,399195,1821987,43,95,274539,5182572,8850,39475,758387,1224,1,94,0,3,312,0
Bacteroides_caccae_53434,700113867,700114480,482,3184562,453964,2074064,163,167,16859,78801,139,80,437105,1995263,24,87,300206,5675992,9591,12129,223863,411,1,86,0,0,80,0
Bacteroides_caccae_53434,700113867,700161872,679,3207487,458032,2088966,274,187,29067,129931,260,124,428965,1959035,14,63,294922,5572706,9477,19237,369902,654,1,62,0,1,123,0
Bacteroides_caccae_53434,700113867,700161967,881,3207094,457930,2088718,331,252,31237,141233,317,164,426693,1947485,14,88,293212,5539781,9462,20914,402116,669,1,87,0,1,163,0
Bacteroides_caccae_53434,700113867,700172498,477,3200773,457046,2084645,160,168,16952,79084,143,83,440094,2005561,17,85,301279,5705678,9726,12165,224673,414,2,83,0,0,83,0
Bacteroides_caccae_53434,700113867,700173546,494,3204532,457595,2087029,173,157,16956,79086,143,81,440639,2007943,30,76,301691,5712421,9717,12163,224681,414,2,74,0,0,81,0
Bacteroides_caccae_53434,700113867,ERR912100,572,3208019,458112,2089322,218,164,19236,87023,203,88,438876,2002299,15,76,301087,5696105,9705,13099,247541,429,1,75,0,1,87,0
Bacteroides_caccae_53434,700113867,ERR912124,494,3192902,455768,2079501,183,146,18531,84306,171,79,437237,1995195,12,67,300042,5675859,9684,12786,239712,420,0,67,0,0,79,0
Bacteroides_caccae_53434,700113975,ERR912136,350,3180102,454321,2071169,103,150,7354,33164,75,34,446967,2038005,28,116,306475,5797670,9870,5022,94293,177,5,111,0,0,34,0
Bacteroides_caccae_53434,700113975,ERR912162,997,3186923,455165,2075605,366,256,35551,160895,333,163,419614,1914710,33,93,288118,5446646,9366,24096,457878,711,2,91,0,0,163,0
Bacteroides_caccae_53434,700114000,pluto3-11-30-0_,347,3209128,458287,2090020,84,161,5016,21497,36,21,453271,2068523,48,140,311397,5884155,10017,2936,61420,135,5,135,0,0,21,0
Bacteroides_caccae_53434,700114082,SRR413615,2342,3213145,458541,2092579,864,644,79356,361391,811,493,379185,1731188,53,151,261213,4924065,8286,53742,1028514,1917,2,149,0,2,491,0
Bacteroides_caccae_53434,700114218,ERR912168,477,3206590,458062,2088436,153,172,12111,56634,120,87,445951,2031802,33,85,305419,5780183,9804,8573,161080,249,0,85,0,0,87,0
Bacteroides_caccae_53434,700114480,700116296,461,3184198,453924,2073833,160,156,16857,78768,138,77,437067,1995065,22,79,300167,5675416,9612,12132,223761,411,1,78,0,0,77,0
Bacteroides_caccae_53434,700114480,700161743,447,3184350,453847,2073942,159,145,16850,78789,138,77,436997,1995153,21,68,300219,5675658,9582,12128,223828,411,2,66,0,0,77,0
Bacteroides_caccae_53434,700114480,700161872,735,3185017,454003,2074377,287,218,23986,109794,267,137,430017,1964583,20,81,295723,5588552,9474,16688,312160,534,2,79,0,1,136,0
Bacteroides_caccae_53434,700114480,700161967,653,3185125,453986,2074455,237,215,20796,94307,218,113,433190,1980148,19,102,298464,5632359,9621,13958,268573,390,2,100,0,1,112,0
Bacteroides_caccae_53434,700114480,700171859,487,3182400,453616,2072676,165,171,16848,78770,138,79,436768,1993906,27,92,300015,5672088,9615,12128,223771,411,2,90,0,0,79,0
Bacteroides_caccae_53434,700114480,700172279,494,3185843,454146,2074906,159,182,16857,78796,139,80,437289,1996110,20,102,300329,5678392,9609,12131,223846,411,1,101,0,0,80,0
Bacteroides_caccae_53434,700114480,700172393,499,3184730,453972,2074177,164,181,16349,76510,131,75,437623,1997667,33,106,300564,5682816,9621,11797,217331,402,1,105,0,0,75,0
Bacteroides_caccae_53434,700114480,700173546,122,3182380,453612,2072646,29,60,50,250,3,0,453562,2072396,26,60,312094,5895089,10005,34,710,6,3,57,0,0,0,0
Bacteroides_caccae_53434,700114480,ERR912014,428,3160305,450765,2058333,142,146,14046,64638,119,66,436719,1993695,23,80,299950,5671553,9582,9791,183775,348,2,78,0,0,66,0
Bacteroides_caccae_53434,700114480,ERR912100,339,3185824,454112,2074907,125,121,9024,41061,107,40,445088,2033846,18,81,306179,5785510,9849,6293,116722,168,2,79,0,1,39,0
Bacteroides_caccae_53434,700114480,ERR912124,267,3170862,451807,2065191,91,108,6759,31567,71,27,445048,2033624,20,81,306137,5784877,9858,4972,89600,129,1,80,0,0,27,0
Bacteroides_caccae_53434,700114480,ERR912164,493,3184140,453872,2073826,167,172,16644,77869,140,78,437228,1995957,27,94,300328,5677934,9609,11995,221207,405,1,93,0,0,78,0
Bacteroides_caccae_53434,700116201,700164050,1658,3196222,455833,2081520,612,439,68941,312566,589,303,386892,1768954,23,136,266482,5031845,8535,47008,889067,1623,4,132,0,1,302,0
Bacteroides_caccae_53434,700116296,700161872,664,3206928,457950,2088624,271,183,27168,121484,252,123,430782,1967140,19,60,296114,5595790,9516,17998,345821,633,1,59,0,1,122,0
Bacteroides_caccae_53434,700116296,700161967,871,3206505,457841,2088352,330,249,31248,141226,315,158,426593,1947126,15,91,293189,5538712,9477,20910,402099,669,1,90,0,1,157,0
Bacteroides_caccae_53434,700116296,700172498,459,3200122,456953,2084235,157,162,16958,79075,142,80,439995,2005160,15,82,301241,5704507,9732,12165,224646,414,2,80,0,0,80,0
Bacteroides_caccae_53434,700116296,700173546,467,3203940,457508,2086656,168,144,17010,79347,145,78,440498,2007309,23,66,301596,5710605,9726,12206,225415,420,1,65,0,0,78,0
Bacteroides_caccae_53434,700116296,ERR912100,562,3207428,458016,2088956,218,161,19263,87077,201,86,438753,2001879,17,75,301048,5694869,9720,13105,247697,429,1,74,0,1,85,0
Bacteroides_caccae_53434,700116296,ERR912124,485,3192211,455668,2079065,182,146,16410,74765,166,72,439258,2004300,16,74,301452,5701713,9735,11324,212587,384,0,74,0,0,72,0
Bacteroides_caccae_53434,700116296,ERR912164,118,3205984,457792,2088021,19,74,50,229,3,0,457742,2087792,16,74,313994,5939221,10161,39,648,0,0,74,0,0,0,0
Bacteroides_caccae_53434,700116668,ERR912037,3667,3210951,458628,2091251,1481,857,146491,670465,1449,763,312137,1420786,32,94,214101,4041231,7026,100374,1907946,3075,4,90,0,3,758,2
Bacteroides_caccae_53434,700116668,ERR912059,799,3206934,457982,2088685,291,237,26831,122026,272,181,431151,1966659,19,56,295427,5595016,9534,18657,346851,570,2,54,0,3,178,0
Bacteroides_caccae_53434,700116730,700161429,466,3206447,457865,2088292,97,229,7549,35347,67,51,450316,2052945,30,178,308499,5840418,9918,5495,100354,192,9,169,0,0,51,0
Bacteroides_caccae_53434,700116730,ERR912052,465,3211793,458640,2091737,101,222,7559,35370,67,51,451081,2056367,34,171,309041,5850076,9984,5499,100419,192,7,164,0,0,51,0
Bacteroides_caccae_53434,700116730,ERR912071,445,3210698,458485,2091046,98,213,7559,35379,68,51,450926,2055667,30,162,308939,5848102,9960,5498,100447,192,5,157,0,0,51,0
Bacteroides_caccae_53434,700116730,ERR912087,163,3211573,458613,2091605,19,106,151,738,3,0,458462,2090867,16,106,314388,5948049,10164,127,2078,9,3,103,0,0,0,0
Bacteroides_caccae_53434,700116730,ERR912122,180,3211507,458593,2091557,23,112,90,420,5,1,458503,2091137,18,111,314451,5948799,10161,64,1196,0,6,105,0,0,1,0
Bacteroides_caccae_53434,700116730,ERR912144,185,3212767,458772,2092381,21,118,201,975,6,1,458571,2091406,15,117,314467,5949578,10173,163,2753,9,5,112,0,0,1,0
Bacteroides_caccae_53434,700116730,ERR912189,170,3213145,458820,2092632,15,112,161,801,2,0,458659,2091831,13,112,314530,5950787,10176,138,2256,9,6,106,0,0,0,0
Bacteroides_caccae_53434,700122408,ERR912074,2457,3100258,443430,2019315,925,659,122145,551427,862,507,321285,1467888,63,152,221783,4174828,7053,81468,1570308,2505,5,147,0,5,502,0
Bacteroides_caccae_53434,700161429,ERR912087,458,3211666,458623,2091702,106,224,8848,41192,71,40,449775,2050510,35,184,308273,5833372,9885,6303,117027,246,10,174,0,0,40,0
Bacteroides_caccae_53434,700161429,ERR912107,476,3198569,456791,2083150,104,237,7549,35347,67,50,449242,2047803,37,187,307779,5825712,9918,5495,100354,192,13,174,0,0,50,0
Bacteroides_caccae_53434,700161429,ERR912117,471,3211481,458568,2091587,100,233,7549,35350,67,50,451019,2056237,33,183,309031,5849738,9942,5495,100363,192,8,175,0,0,50,0
Bacteroides_caccae_53434,700161429,ERR912122,488,3211754,458622,2091754,108,240,7070,32968,70,40,451552,2058786,38,200,309492,5856927,9939,5081,93646,177,13,187,0,0,40,0
Bacteroides_caccae_53434,700161429,ERR912144,482,3211580,458590,2091649,108,238,7549,35347,67,51,451041,2056302,41,187,309042,5849928,9936,5495,100354,192,11,176,0,1,50,0
Bacteroides_caccae_53434,700161429,ERR912148,372,3210916,458469,2091199,90,177,7549,35351,68,51,450920,2055848,22,126,309015,5848608,9921,5497,100364,192,9,117,0,1,50,0
Bacteroides_caccae_53434,700161429,ERR912178,471,3211647,458607,2091692,101,228,7549,35347,67,50,451058,2056345,34,178,309028,5850080,9927,5495,100354,192,10,168,0,0,50,0
Bacteroides_caccae_53434,700161429,ERR912189,474,3213192,458826,2092694,102,237,7549,35347,68,50,451277,2057347,34,187,309218,5852878,9945,5495,100354,192,13,174,0,0,50,0
Bacteroides_caccae_53434,700161533,ERR911971,3693,3203479,457513,2086386,1421,908,143599,651753,1364,740,313914,1434633,57,168,216669,4080270,6960,97097,1855024,3138,2,166,0,5,734,1
Bacteroides_caccae_53434,700161743,700161872,644,3207199,457866,2088804,269,164,27176,121598,253,121,430690,1967206,16,43,296182,5595950,9486,18020,346144,630,0,43,0,1,120,0
Bacteroides_caccae_53434,700161743,700161967,863,3207996,457956,2089329,331,240,31280,141459,317,157,426676,1947870,14,83,293331,5540826,9453,20946,402762,669,2,81,0,1,156,0
Bacteroides_caccae_53434,700161743,700172498,443,3200683,456906,2084601,156,145,16965,79175,142,80,439941,2005426,14,65,301320,5705259,9699,12185,224926,414,3,62,0,0,80,0
Bacteroides_caccae_53434,700161743,700173546,459,3204478,457456,2087027,167,137,16463,76889,134,72,440993,2010138,33,65,302056,5718647,9711,11847,218415,405,2,63,0,0,72,0
Bacteroides_caccae_53434,700161743,ERR912100,548,3208739,458081,2089809,218,146,19302,87323,203,85,438779,2002486,15,61,301187,5696569,9702,13151,248389,429,2,59,0,1,84,0
Bacteroides_caccae_53434,700161743,ERR912124,467,3193396,455718,2079838,180,131,17126,78241,166,73,438592,2001597,14,58,301055,5694034,9702,11891,222445,387,1,57,0,0,73,0
Bacteroides_caccae_53434,700161872,700161967,983,3208571,458129,2089704,373,292,33188,149904,351,201,424941,1939800,22,91,292108,5517860,9432,22195,426809,708,2,89,0,2,199,0
Bacteroides_caccae_53434,700161872,700171859,696,3205802,457761,2087892,276,198,27158,121470,252,124,430603,1966422,24,74,296028,5593722,9516,17999,345778,633,2,72,0,1,123,0
Bacteroides_caccae_53434,700161872,700172279,697,3209320,458303,2090173,270,207,27186,121604,253,126,431117,1968569,17,81,296337,5599845,9525,18016,346169,627,1,80,0,1,125,0
Bacteroides_caccae_53434,700161872,700172393,698,3207754,458061,2089137,274,205,27152,121482,252,127,430909,1967655,22,78,296182,5597273,9510,18006,345813,627,1,77,0,1,126,0
Bacteroides_caccae_53434,700161872,700172498,729,3201859,457181,2085372,284,218,24166,110405,271,141,433015,1974967,13,77,296808,5618493,9600,16767,313908,540,3,74,0,1,140,0
Bacteroides_caccae_53434,700161872,700173546,750,3205854,457745,2087913,298,208,23692,108216,264,132,434053,1979697,34,76,297572,5631919,9600,16434,307683,531,3,73,0,1,131,0
Bacteroides_caccae_53434,700161872,ERR912014,666,3183545,454889,2073451,261,189,26687,119108,242,119,428202,1954343,19,70,294005,5559577,9447,17601,339102,621,2,68,0,1,118,0
Bacteroides_caccae_53434,700161872,ERR912100,671,3209500,458300,2090301,259,203,21375,96654,242,131,436925,1993647,17,72,299828,5671459,9654,14546,274933,483,2,70,0,2,129,0
Bacteroides_caccae_53434,700161872,ERR912124,592,3194555,455988,2080592,220,184,19144,87301,202,116,436844,1993291,18,68,299760,5670450,9663,13245,248217,441,1,67,0,1,115,0
Bacteroides_caccae_53434,700161872,ERR912164,692,3207940,458074,2089299,279,192,27088,121064,254,120,430986,1968235,25,72,296356,5598821,9528,17887,344684,621,1,71,0,1,119,0
Bacteroides_caccae_53434,700161967,700171859,898,3205818,457717,2087920,333,265,31246,141238,317,160,426471,1946682,16,105,293123,5537443,9480,20915,402130,669,2,103,0,1,159,0
Bacteroides_caccae_53434,700161967,700172279,907,3209262,458255,2090151,328,275,31202,141053,311,163,427053,1949098,17,112,293481,5544333,9480,20877,401613,669,1,111,0,1,162,0
Bacteroides_caccae_53434,700161967,700172393,902,3207462,457970,2088964,328,273,31140,140802,309,164,426830,1948162,19,109,293339,5541676,9471,20844,400893,669,1,108,0,1,163,0
Bacteroides_caccae_53434,700161967,700172498,651,3201835,457127,2085374,231,216,21114,95583,223,112,436013,1989791,8,104,299475,5660151,9747,14128,272225,396,3,101,0,1,111,0
Bacteroides_caccae_53434,700161967,700173546,657,3208033,458015,2089370,240,205,21115,95520,223,111,436900,1993850,17,94,300138,5671671,9741,14104,272054,402,2,92,0,1,110,0
Bacteroides_caccae_53434,700161967,ERR912014,882,3186335,455254,2075301,325,259,30573,137880,310,160,424681,1937421,15,99,291560,5511289,9414,20343,392643,654,1,98,0,2,158,0
Bacteroides_caccae_53434,700161967,ERR912100,396,3212061,458615,2091999,121,146,12052,54311,113,71,446563,2037688,8,75,306823,5796317,9924,7827,154878,228,2,73,0,0,71,0
Bacteroides_caccae_53434,700161967,ERR912124,394,3196739,456254,2082049,122,144,11905,53686,113,70,444349,2028363,9,74,305557,5769647,9885,7721,153112,225,1,73,0,0,70,0
Bacteroides_caccae_53434,700161967,ERR912164,905,3210512,458405,2091012,336,263,31221,141056,319,163,427184,1949956,17,100,293644,5546726,9498,20878,401636,654,1,99,0,1,162,0
Bacteroides_caccae_53434,700171648,ERR911970,1413,3180613,453845,2071368,478,384,55074,249351,438,263,398771,1822017,40,121,275541,5181744,8766,36248,710485,1320,4,117,0,0,263,0
Bacteroides_caccae_53434,700171648,SRR2822459,1393,3179225,453671,2070447,471,386,55185,249975,444,271,398486,1820472,27,115,275288,5177383,8745,36370,712244,1311,3,112,0,1,270,0
Bacteroides_caccae_53434,700171859,700172498,490,3201814,457204,2085341,162,177,16975,79215,142,82,440229,2006126,20,95,301370,5707261,9747,12197,225034,414,3,92,0,0,82,0
Bacteroides_caccae_53434,700171859,700173546,500,3205732,457758,2087832,173,163,17018,79423,145,80,440740,2008409,28,83,301768,5713721,9738,12219,225630,420,3,80,0,0,80,0
Bacteroides_caccae_53434,700171859,ERR912100,587,3206836,457905,2088580,222,173,19268,87154,202,87,438637,2001426,20,86,300987,5693571,9720,13126,247907,429,2,84,0,1,86,0
Bacteroides_caccae_53434,700171859,ERR912124,505,3191946,455600,2078916,185,157,16423,74860,166,73,439177,2004056,19,84,301418,5701009,9741,11351,212845,384,1,83,0,0,73,0
Bacteroides_caccae_53434,700171859,ERR912164,153,3205244,457667,2087552,24,93,50,221,3,0,457617,2087331,21,93,313937,5937901,10155,37,626,0,1,92,0,0,0,0
Bacteroides_caccae_53434,700172279,700172498,494,3202655,457329,2085885,156,186,16957,79137,143,83,440372,2006748,13,103,301462,5709044,9738,12184,224813,414,2,101,0,0,83,0
Bacteroides_caccae_53434,700172279,700173546,502,3206418,457868,2088276,167,172,21434,99260,150,82,436434,1989016,17,90,298916,5658502,9630,15123,282141,516,2,88,0,0,82,0
Bacteroides_caccae_53434,700172279,ERR912100,595,3210287,458445,2090823,217,183,19295,87288,202,90,439150,2003535,15,93,301290,5699598,9717,13141,248294,429,1,92,0,1,89,0
Bacteroides_caccae_53434,700172279,ERR912124,517,3194892,456070,2080813,180,168,17128,78228,166,78,438942,2002585,14,90,301141,5696888,9726,11889,222408,387,0,90,0,0,78,0
Bacteroides_caccae_53434,700172393,700172498,494,3201311,457102,2085000,160,182,16461,76885,135,78,440641,2008115,25,104,301667,5712940,9738,11852,218398,405,2,102,0,0,78,0
Bacteroides_caccae_53434,700172393,700173546,512,3205066,457646,2087381,172,174,24275,112340,152,85,433371,1975041,20,89,296954,5618602,9567,16972,319469,579,1,88,0,1,84,0
Bacteroides_caccae_53434,700172393,ERR912100,594,3208518,458161,2089650,219,182,19278,87217,202,91,438883,2002433,17,91,301129,5696453,9717,13133,248089,429,1,90,0,1,90,0
Bacteroides_caccae_53434,700172393,ERR912124,517,3193414,455819,2079839,184,166,17115,78177,167,79,438704,2001662,17,87,301021,5694236,9729,11888,222256,387,0,87,0,0,79,0
Bacteroides_caccae_53434,700172498,ERR912014,438,3179829,454364,2071101,140,157,14347,65976,125,69,440017,2005125,15,88,301171,5704490,9714,10006,187571,351,3,85,0,0,69,0
Bacteroides_caccae_53434,700172498,ERR912100,337,3203022,457347,2086144,118,125,9089,41320,108,41,448258,2044824,10,84,307344,5817162,9966,6326,117463,171,3,81,0,1,40,0
Bacteroides_caccae_53434,700172498,ERR912124,263,3188304,455061,2076584,84,110,6797,31711,72,28,448264,2044873,12,82,307367,5817271,9981,4993,90011,129,2,80,0,0,28,0
Bacteroides_caccae_53434,700172498,ERR912164,489,3201497,457127,2085157,164,173,17027,79465,146,84,440100,2005692,18,89,301302,5706045,9729,12243,225738,414,2,87,0,0,84,0
Bacteroides_caccae_53434,700173546,ERR912014,448,3185631,455192,2074825,153,140,14337,65928,125,67,440855,2008897,28,73,301795,5715170,9726,9993,187440,351,2,71,0,0,67,0
Bacteroides_caccae_53434,700173546,ERR912100,355,3208903,458187,2089913,132,114,9195,41791,112,40,448992,2048122,20,74,307909,5826485,9972,6391,118805,177,2,72,0,1,39,0
Bacteroides_caccae_53434,700173546,ERR912124,276,3194092,455887,2080288,95,99,6873,32060,75,27,449014,2048228,20,72,307929,5826762,9993,5042,91003,135,2,70,0,0,27,0
Bacteroides_caccae_53434,700173546,ERR912164,499,3207355,457971,2088916,172,161,16953,79123,143,82,441018,2009793,29,79,301977,5717667,9735,12184,224771,414,1,78,0,0,82,0
Bacteroides_caccae_53434,ERR911970,ERR912037,4178,3193840,456406,2080085,1568,1076,166505,756019,1536,974,289901,1324066,32,102,199559,3766216,6423,113013,2151393,3651,3,98,1,4,969,1
Bacteroides_caccae_53434,ERR912014,ERR912100,566,3187485,455442,2076050,212,164,18578,83682,195,81,436864,1992368,17,83,299475,5667978,9651,12523,238109,414,2,81,0,1,80,0
Bacteroides_caccae_53434,ERR912014,ERR912124,495,3175787,453622,2068460,181,150,15932,72275,163,69,437690,1996185,18,81,300111,5678766,9678,10887,205569,369,1,80,0,0,69,0
Bacteroides_caccae_53434,ERR912037,ERR912059,3536,3208771,458258,2089883,1403,845,144771,662976,1377,751,313487,1426907,26,94,215110,4058561,7050,99124,1886750,3054,4,90,0,6,743,2
Bacteroides_caccae_53434,ERR912037,ERR912175,3688,3213717,458985,2093058,1484,870,147813,676188,1451,768,311172,1416870,33,102,213595,4029998,7017,101135,1924312,3117,3,99,0,3,763,2
Bacteroides_caccae_53434,ERR912052,ERR912087,459,3216082,459268,2094547,110,218,7060,32882,66,40,452208,2061665,44,178,309931,5865044,10020,5067,93402,177,8,170,0,0,40,0
Bacteroides_caccae_53434,ERR912052,ERR912107,468,3204293,457637,2086838,108,225,7559,35370,67,50,450078,2051468,41,175,308342,5836081,9981,5499,100419,192,11,164,0,0,50,0
Bacteroides_caccae_53434,ERR912052,ERR912117,467,3217250,459402,2095314,100,228,7559,35374,67,50,451843,2059940,33,178,309619,5860199,10002,5499,100431,192,6,172,0,0,50,0
Bacteroides_caccae_53434,ERR912052,ERR912122,482,3215874,459231,2094405,112,232,7070,32953,70,40,452161,2061452,42,192,309890,5864461,10005,5079,93603,177,11,181,0,0,40,0
Bacteroides_caccae_53434,ERR912052,ERR912144,484,3217296,459427,2095331,112,232,7559,35370,67,51,451868,2059961,45,181,309611,5860261,10011,5499,100419,192,9,172,0,1,50,0
Bacteroides_caccae_53434,ERR912052,ERR912148,370,3216632,459302,2094895,93,170,7549,35340,68,51,451753,2059555,25,119,309575,5859094,9996,5495,100333,192,7,112,0,1,50,0
Bacteroides_caccae_53434,ERR912052,ERR912178,467,3217359,459442,2095376,101,221,7559,35370,67,50,451883,2060006,34,171,309609,5860416,9993,5499,100419,192,8,163,0,0,50,0
Bacteroides_caccae_53434,ERR912052,ERR912189,471,3217498,459455,2095475,106,227,7060,32882,67,40,452395,2062593,39,187,310063,5867693,10023,5067,93402,177,11,176,0,0,40,0
Bacteroides_caccae_53434,ERR912059,ERR912175,822,3209807,458354,2090569,289,251,28370,128971,271,183,429984,1961598,18,68,294594,5580663,9537,19746,366576,591,1,67,0,3,180,0
Bacteroides_caccae_53434,ERR912071,ERR912087,441,3214735,459076,2093686,107,209,7060,32891,67,40,452016,2060795,40,169,309803,5862598,9984,5066,93430,177,6,163,0,0,40,0
Bacteroides_caccae_53434,ERR912071,ERR912107,452,3202994,457456,2086014,104,218,7559,35379,68,50,449897,2050635,36,168,308217,5833734,9954,5498,100447,192,9,159,0,0,50,0
Bacteroides_caccae_53434,ERR912071,ERR912117,451,3216053,459239,2094555,101,217,7559,35385,68,50,451680,2059170,33,167,309506,5858038,9966,5498,100465,192,4,163,0,0,50,0
Bacteroides_caccae_53434,ERR912071,ERR912122,465,3214820,459081,2093745,109,222,7080,33000,71,40,452001,2060745,38,182,309790,5862464,9981,5083,93740,177,9,173,0,0,40,0
Bacteroides_caccae_53434,ERR912071,ERR912144,465,3216083,459260,2094557,110,222,7559,35379,68,51,451701,2059178,42,171,309497,5858056,9981,5498,100447,192,7,164,0,1,50,0
Bacteroides_caccae_53434,ERR912071,ERR912148,359,3215444,459140,2094130,91,163,7549,35342,69,51,451591,2058788,22,112,309474,5856927,9963,5496,100338,192,5,107,0,1,50,0
Bacteroides_caccae_53434,ERR912071,ERR912178,451,3216204,459281,2094646,103,210,7559,35379,68,50,451722,2059267,35,160,309497,5858338,9966,5498,100447,192,6,154,0,0,50,0
Bacteroides_caccae_53434,ERR912071,ERR912189,453,3216301,459283,2094711,104,218,7559,35379,69,50,451724,2059332,35,168,309520,5858492,9984,5498,100447,192,9,159,0,0,50,0
Bacteroides_caccae_53434,ERR912087,ERR912107,173,3204096,457609,2086731,27,112,161,784,2,0,457448,2085947,25,112,313698,5933970,10173,134,2209,9,6,106,0,0,0,0
Bacteroides_caccae_53434,ERR912087,ERR912122,175,3217309,459440,2095348,28,115,161,801,2,0,459279,2094547,26,115,314998,5958464,10179,138,2256,9,7,108,0,0,0,0
Bacteroides_caccae_53434,ERR912100,ERR912164,593,3211859,458621,2091875,225,172,19375,87628,207,89,439246,2004247,18,83,301426,5701589,9726,13192,249263,429,1,82,0,1,88,0
Bacteroides_caccae_53434,ERR912107,ERR912122,185,3203987,457587,2086650,28,116,90,418,5,1,457497,2086232,23,115,313746,5934777,10173,63,1191,0,10,105,0,0,1,0
Bacteroides_caccae_53434,ERR912107,ERR912178,199,3205396,457792,2087563,27,122,120,615,4,1,457672,2086948,23,121,313836,5936835,10173,97,1748,0,6,115,0,0,1,0
Bacteroides_caccae_53434,ERR912117,ERR912122,212,3216968,459363,2095134,30,132,90,418,5,1,459273,2094716,25,131,315023,5958943,10182,63,1191,0,5,126,0,0,1,0
Bacteroides_caccae_53434,ERR912122,ERR912148,299,3216283,459254,2094668,49,176,80,378,5,0,459174,2094290,44,176,314981,5957716,10173,58,1076,0,6,170,0,0,0,0
Bacteroides_caccae_53434,ERR912122,ERR912178,209,3217295,459429,2095346,31,124,90,420,5,1,459339,2094926,26,123,315027,5959569,10182,64,1196,0,7,116,0,0,1,0
Bacteroides_caccae_53434,ERR912122,ERR912189,189,3218742,459639,2096279,28,118,90,418,5,1,459549,2095861,23,117,315201,5962182,10200,63,1191,0,10,107,0,0,1,0
Bacteroides_caccae_53434,ERR912124,ERR912164,514,3196468,456248,2081889,187,157,16491,75170,170,75,439757,2006719,17,82,301843,5708573,9741,11392,213734,384,0,82,0,0,75,0
Bacteroides_caccae_53434,ERR912136,ERR912162,1225,3200992,457227,2084786,441,326,38639,174916,401,194,418588,1909870,40,132,287225,5433034,9351,26250,497691,807,3,129,0,1,193,0
Bacteroides_caccae_53434,SRR2822459,ERR912037,4175,3193390,456371,2079767,1565,1086,165952,753639,1532,979,290419,1326128,33,107,199920,3772059,6405,112612,2144651,3654,3,103,1,4,974,1
