species_name,sample 1,sample 2,core_diff,core_len,core_len_4D,core_len_1D,core_diff_4D,core_diff_1D,recomb_len_4D,recomb_len_1D,recomb_diff_4D,recomb_diff_1D,clonal_len_4D,clonal_len_1D,clonal_diff_4D,clonal_diff_1D,clonal_n,clonal_m,clonal_nn,recomb_n,recomb_m,recomb_nn,clonal_mut_n,clonal_mut_m,clonal_mut_nn,recomb_mut_n,recomb_mut_m,recomb_mut_nn
Barnesiella_intestinihominis_62208,700014486,700103558,1899,2470191,351917,1603421,758,442,19793,88136,731,338,332124,1515285,27,104,232028,4305979,7848,13195,250826,387,0,104,0,0,338,0
Barnesiella_intestinihominis_62208,700014486,700106412,1893,2468045,351624,1602049,760,440,20006,89258,735,336,331618,1512791,25,104,231571,4298951,7851,13384,253988,402,0,104,0,0,336,0
Barnesiella_intestinihominis_62208,700014486,700116611,7693,2464530,351114,1599702,3135,1800,84538,379246,3094,1632,266576,1220456,41,168,187551,3467442,6375,57087,1078758,1893,1,167,0,5,1626,1
Barnesiella_intestinihominis_62208,700014486,700165167,3403,2393933,342992,1554197,1375,810,35274,157680,1343,717,307718,1396517,32,93,213521,3969217,6813,23812,448535,693,1,92,0,2,715,0
Barnesiella_intestinihominis_62208,700014724,700037852,2545,2469901,351604,1603218,979,597,27223,124724,954,526,324381,1478494,25,71,226424,4201300,7758,18951,354570,651,0,70,1,2,524,0
Barnesiella_intestinihominis_62208,700014724,ERR912005,5398,2473291,352202,1605395,2097,1326,60319,270190,2073,1188,291883,1335205,24,138,205160,3793306,7149,40492,768809,1269,0,137,1,3,1185,0
Barnesiella_intestinihominis_62208,700014954,700016542,3937,2444431,348203,1586706,1607,914,43094,194116,1583,812,305109,1392590,24,102,213690,3956859,7221,28971,552459,918,1,101,0,5,807,0
Barnesiella_intestinihominis_62208,700014954,700024318,5877,2426541,345341,1575003,2382,1296,67854,308306,2354,1156,277487,1266697,28,140,194712,3598752,6627,46428,877053,1437,2,138,0,4,1152,0
Barnesiella_intestinihominis_62208,700014954,700024449,6138,2446739,348600,1588171,2505,1341,67928,308459,2479,1213,280672,1279712,26,128,196253,3636238,6645,46624,877265,1488,1,127,0,4,1208,1
Barnesiella_intestinihominis_62208,700014954,700033665,797,2435222,347600,1580816,323,198,9311,41583,319,164,338289,1539233,4,34,235388,4374916,7395,6111,118434,204,1,33,0,1,163,0
Barnesiella_intestinihominis_62208,700014954,700034254,4154,2440843,347650,1584317,1672,899,48785,219262,1660,810,298865,1365055,12,89,209948,3878185,7032,32407,624353,1026,3,86,0,3,805,2
Barnesiella_intestinihominis_62208,700014954,700034926,4950,2440660,347509,1584171,2045,1095,54491,246614,2029,991,293018,1337557,16,104,205459,3800309,6903,36934,701729,1179,2,102,0,4,987,0
Barnesiella_intestinihominis_62208,700014954,700037916,714,2449155,348920,1589742,282,187,8269,37259,273,152,340651,1552483,9,35,237543,4411911,7995,5542,106052,183,0,35,0,0,152,0
Barnesiella_intestinihominis_62208,700014954,700095647,4625,2445124,348335,1587123,1849,1074,49771,225475,1826,966,298564,1361648,23,108,208946,3868990,7008,33811,641534,1080,2,106,0,4,962,0
Barnesiella_intestinihominis_62208,700014954,700105312,4759,2446963,348674,1588348,1944,1068,52552,236796,1914,957,296122,1351552,30,111,207627,3839979,7050,35249,674065,1074,2,109,0,3,954,0
Barnesiella_intestinihominis_62208,700014954,700161533,4841,2433834,346667,1579699,1955,1077,54407,247582,1946,986,292260,1332117,9,91,204525,3785010,6816,37046,704530,1170,3,88,0,3,983,0
Barnesiella_intestinihominis_62208,700014954,700173483,3405,2444690,348270,1586842,1370,757,39216,176793,1359,666,309054,1410049,11,91,216487,4006343,7317,26176,503381,822,4,87,0,2,662,2
Barnesiella_intestinihominis_62208,700014954,ERR911961,832,2448330,348809,1589250,317,216,7785,34807,309,167,341024,1554443,8,49,237908,4417438,7983,5093,99187,141,1,48,0,0,167,0
Barnesiella_intestinihominis_62208,700014954,ERR911971,4857,2448805,348891,1589526,1946,1131,50321,227220,1925,992,298570,1362306,21,139,208881,3870954,7083,34190,646408,1062,3,136,0,4,988,0
Barnesiella_intestinihominis_62208,700014954,ERR912025,5113,2445424,348398,1587359,2075,1179,56435,253843,2056,1064,291963,1333516,19,115,204911,3788656,6981,37872,722505,1152,3,112,0,3,1061,0
Barnesiella_intestinihominis_62208,700014954,ERR912124,5146,2441173,347760,1584518,2064,1171,58009,262559,2048,1045,289751,1321959,16,126,202660,3756356,6861,39659,746785,1233,2,124,0,2,1043,0
Barnesiella_intestinihominis_62208,700014954,ERR912154,5713,2442710,347978,1585526,2293,1345,64499,290979,2280,1234,283479,1294547,13,111,199090,3677819,6732,43434,828126,1377,2,109,0,2,1232,0
Barnesiella_intestinihominis_62208,700016542,700024318,5449,2448359,348187,1589225,2215,1217,62047,281208,2183,1087,286140,1308017,32,130,200871,3716322,6858,42566,799681,1377,0,130,0,4,1083,0
Barnesiella_intestinihominis_62208,700016542,700024449,5504,2468154,351374,1602124,2245,1200,59177,268526,2205,1078,292197,1333598,40,122,204135,3789738,6921,41009,763195,1374,0,122,0,3,1074,1
Barnesiella_intestinihominis_62208,700016542,700033665,4278,2429947,346737,1577385,1750,967,48185,216653,1723,866,298552,1360732,27,101,208695,3866898,6603,32352,616623,984,1,100,0,6,860,0
Barnesiella_intestinihominis_62208,700016542,700034254,5156,2460475,350311,1597121,2120,1087,59993,272046,2092,967,290318,1325075,28,120,203301,3765174,6750,41107,773606,1425,1,119,0,1,964,2
Barnesiella_intestinihominis_62208,700016542,700034926,3481,2463665,350579,1599176,1488,761,36399,163461,1454,662,314180,1435715,34,99,220223,4079500,7422,24595,464981,807,0,99,0,4,658,0
Barnesiella_intestinihominis_62208,700016542,700037916,4159,2446272,348212,1587859,1686,950,46716,210785,1653,848,301496,1377074,33,102,211381,3912605,7236,31533,599796,1026,1,101,0,5,843,0
Barnesiella_intestinihominis_62208,700016542,700095647,3782,2467630,351275,1601794,1512,891,41369,187815,1475,789,309906,1413979,37,102,216558,4018044,7335,28566,533946,933,0,102,0,4,785,0
Barnesiella_intestinihominis_62208,700016542,700105312,4128,2468223,351421,1602237,1691,949,44993,202224,1648,828,306428,1400013,43,121,214917,3977802,7320,30224,575500,948,0,121,0,3,825,0
Barnesiella_intestinihominis_62208,700016542,700161533,3939,2454584,349377,1593241,1583,899,43733,199246,1565,822,305644,1393995,18,77,213377,3961441,7167,30388,566375,975,1,76,0,3,819,0
Barnesiella_intestinihominis_62208,700016542,700173483,4431,2464913,350873,1600013,1829,942,50372,229498,1798,822,300501,1370515,31,120,209904,3894597,7044,34898,652354,1242,2,118,0,2,818,2
Barnesiella_intestinihominis_62208,700016542,ERR911961,4270,2445312,348072,1587270,1727,991,45918,207040,1699,872,302154,1380230,28,119,211913,3921523,7254,30919,589247,954,2,117,0,5,867,0
Barnesiella_intestinihominis_62208,700016542,ERR911971,3942,2469951,351629,1603301,1572,941,41598,187548,1539,811,310031,1415753,33,130,216693,4023195,7371,28596,533124,924,1,129,0,4,807,0
Barnesiella_intestinihominis_62208,700016542,ERR912025,4476,2466855,351169,1601339,1829,1057,50015,224552,1801,943,301154,1376787,28,114,211358,3911761,7242,33711,638895,1050,1,113,0,3,940,0
Barnesiella_intestinihominis_62208,700016542,ERR912124,4696,2462641,350539,1598528,1878,1058,51853,235417,1851,944,298686,1363111,27,114,208554,3873684,7095,36032,669055,1164,0,114,0,2,942,0
Barnesiella_intestinihominis_62208,700016542,ERR912154,4500,2464640,350808,1599837,1825,1040,48487,218109,1794,940,302321,1381728,31,100,212298,3925671,7215,32539,620720,1068,0,100,0,2,938,0
Barnesiella_intestinihominis_62208,700021123,700038806,77,2477989,352730,1608425,16,33,281,1215,12,4,352449,1607210,4,29,245890,4567220,8520,198,3441,6,0,29,0,0,4,0
Barnesiella_intestinihominis_62208,700021123,700123827,616,2479306,352938,1609317,237,156,6904,31038,229,107,346034,1578279,8,49,241412,4485067,8358,4795,88154,165,1,48,0,0,107,0
Barnesiella_intestinihominis_62208,700024024,700024615,4045,2438808,346708,1583004,1582,979,42965,193591,1555,871,303743,1389413,27,108,213219,3947709,7311,29328,550542,903,4,104,0,1,870,0
Barnesiella_intestinihominis_62208,700024024,700033502,3981,2462930,350500,1598714,1560,967,44785,204143,1537,845,305715,1394571,23,122,213844,3962642,7227,30875,580579,975,2,120,0,0,845,0
Barnesiella_intestinihominis_62208,700024024,ERR911970,3498,2466609,350984,1601104,1390,838,36689,167211,1366,731,314295,1433893,24,107,219758,4074379,7542,25347,475503,783,2,105,0,0,731,0
Barnesiella_intestinihominis_62208,700024024,ERR912013,3747,2442118,347770,1585039,1480,906,40327,181013,1453,809,307443,1404026,27,97,215315,3989341,7422,27309,514884,846,1,96,0,0,809,0
Barnesiella_intestinihominis_62208,700024024,ERR912021,4138,2462577,350474,1598491,1613,1035,43618,197579,1590,879,306856,1400912,23,156,214998,3980355,7383,29651,562180,906,3,153,0,1,878,0
Barnesiella_intestinihominis_62208,700024024,ERR912032,1082,2466375,350980,1600908,414,298,8951,40016,397,177,342029,1560892,17,121,239192,4435372,8112,5921,113926,201,7,114,0,0,177,0
Barnesiella_intestinihominis_62208,700024024,ERR912062,5042,2464704,350729,1599883,2059,1131,54717,249896,2037,1029,296012,1349987,22,102,206904,3835989,7068,38037,710418,1233,4,98,0,1,1028,0
Barnesiella_intestinihominis_62208,700024024,ERR912090,4503,2462750,350452,1598596,1769,1082,46708,212998,1747,948,303744,1385598,22,134,212465,3937033,7296,32289,605715,990,4,130,0,3,945,0
Barnesiella_intestinihominis_62208,700024024,ERR912135,1179,2466297,350994,1600859,456,303,12423,56221,447,250,338571,1544638,9,53,236389,4389443,8082,8658,159759,246,2,51,0,0,250,0
Barnesiella_intestinihominis_62208,700024024,ERR912194,1278,2464971,350771,1600007,537,279,14388,65568,527,236,336383,1534439,10,43,234969,4360356,7992,9974,186388,342,0,43,0,0,235,1
Barnesiella_intestinihominis_62208,700024318,700024449,6927,2450565,348537,1590610,2821,1497,78119,354477,2793,1344,270418,1236133,28,153,189708,3512232,6459,53960,1007683,1788,0,153,0,3,1340,1
Barnesiella_intestinihominis_62208,700024318,700033665,6104,2412405,343954,1565911,2469,1334,70827,321174,2440,1193,273127,1244737,29,141,191108,3537016,6087,48422,913663,1437,2,139,0,5,1188,0
Barnesiella_intestinihominis_62208,700024318,700034254,7130,2443083,347516,1585762,2871,1498,87831,399248,2845,1364,259685,1186514,26,134,182536,3370913,6093,60396,1135323,2025,1,133,0,3,1359,2
Barnesiella_intestinihominis_62208,700024318,700034926,6308,2445544,347700,1587321,2615,1362,73321,332269,2590,1233,274379,1255052,25,129,193008,3565605,6543,50232,944955,1620,0,129,0,4,1229,0
Barnesiella_intestinihominis_62208,700024318,700037916,6016,2428412,345367,1576191,2417,1327,70535,321338,2387,1184,274832,1254853,30,143,192815,3565111,6633,48546,913890,1578,2,141,0,4,1180,0
Barnesiella_intestinihominis_62208,700024318,700095647,5323,2449517,348373,1589956,2132,1212,59742,270809,2107,1081,288631,1319147,25,131,202600,3747887,6954,40974,770160,1293,0,131,0,4,1077,0
Barnesiella_intestinihominis_62208,700024318,700105312,6278,2450392,348580,1590539,2571,1389,72674,329171,2529,1250,275906,1261368,42,139,193783,3583715,6606,49827,936078,1608,0,139,0,3,1247,0
Barnesiella_intestinihominis_62208,700024318,700161533,6102,2436280,346460,1581273,2444,1349,72965,333189,2432,1241,273495,1248084,12,108,191687,3546088,6477,50502,947460,1605,0,108,0,4,1237,0
Barnesiella_intestinihominis_62208,700024318,700173483,6507,2446708,347979,1588099,2644,1365,81296,370305,2616,1234,266683,1217794,28,131,187113,3459951,6318,56146,1052873,1896,1,130,0,3,1229,2
Barnesiella_intestinihominis_62208,700024318,ERR911961,6076,2427881,345288,1575863,2442,1350,69692,316931,2412,1196,275596,1258932,30,154,193476,3576681,6639,47864,901408,1521,3,151,0,4,1191,1
Barnesiella_intestinihominis_62208,700024318,ERR911971,5397,2452364,348791,1591805,2165,1261,58738,266560,2139,1105,290053,1325245,26,156,203356,3765365,7014,40452,757971,1257,1,155,0,4,1100,1
Barnesiella_intestinihominis_62208,700024318,ERR912025,6614,2449300,348360,1589823,2691,1498,76450,346036,2662,1349,271910,1243787,29,149,191169,3533613,6579,52378,984041,1689,1,148,0,3,1345,1
Barnesiella_intestinihominis_62208,700024318,ERR912124,5395,2446200,347863,1587764,2162,1176,65019,296862,2139,1063,282844,1290902,23,113,197830,3668132,6744,45366,843732,1488,0,113,0,2,1061,0
Barnesiella_intestinihominis_62208,700024318,ERR912154,7468,2445563,347774,1587342,3031,1690,86061,390540,3011,1566,261713,1196802,20,124,184314,3399795,6297,58881,1110801,1938,0,124,0,2,1564,0
Barnesiella_intestinihominis_62208,700024349,ERR911967,5872,2478455,353064,1608775,2355,1364,62623,280696,2306,1136,290441,1328079,49,228,204008,3773203,7026,42130,798443,1515,5,223,0,5,1131,0
Barnesiella_intestinihominis_62208,700024349,ERR912112,7402,2476628,352756,1607557,2996,1656,83689,377999,2948,1473,269067,1229558,48,183,189211,3492923,6540,56792,1075207,1998,1,182,0,6,1467,0
Barnesiella_intestinihominis_62208,700024349,ERR912131,5876,2478723,353093,1608957,2373,1322,65134,292504,2338,1138,287959,1316453,35,184,202187,3740191,6981,43950,831987,1575,3,181,0,5,1133,0
Barnesiella_intestinihominis_62208,700024349,ERR912164,7444,2476805,352821,1607674,3025,1658,83338,376005,2979,1467,269483,1231669,46,191,189507,3498957,6543,56453,1069567,1995,1,190,0,6,1461,0
Barnesiella_intestinihominis_62208,700024449,700033665,6260,2432222,347134,1578824,2542,1356,70831,321387,2520,1232,276303,1257437,22,124,192547,3573728,6036,48712,913913,1536,1,123,0,5,1226,1
Barnesiella_intestinihominis_62208,700024449,700034254,6947,2464292,350904,1599587,2836,1396,80123,364712,2809,1257,270781,1234875,27,139,189260,3509104,6261,55493,1036732,1911,1,138,0,2,1254,1
Barnesiella_intestinihominis_62208,700024449,700034926,6440,2464178,350698,1599462,2672,1371,70817,322476,2639,1247,279881,1276986,33,124,195632,3628753,6573,49234,916544,1650,0,124,0,3,1243,1
Barnesiella_intestinihominis_62208,700024449,700037916,6229,2448423,348586,1589216,2526,1349,70619,321166,2500,1231,277967,1268050,26,118,194400,3603138,6612,48708,913152,1638,1,117,0,4,1226,1
Barnesiella_intestinihominis_62208,700024449,700095647,5495,2469702,351603,1603115,2247,1188,58996,269062,2214,1080,292607,1334053,33,108,204065,3791194,6900,41259,764541,1386,0,108,0,3,1076,1
Barnesiella_intestinihominis_62208,700024449,700105312,6090,2470491,351813,1603649,2491,1299,70281,317891,2449,1161,281532,1285758,42,138,197109,3653457,6708,48228,903870,1575,0,138,0,2,1158,1
Barnesiella_intestinihominis_62208,700024449,700161533,6137,2456855,349759,1594679,2481,1319,69107,316459,2458,1200,280652,1278220,23,119,195513,3632583,6564,48446,899335,1596,1,118,0,2,1197,1
Barnesiella_intestinihominis_62208,700024449,700173483,6251,2467579,351330,1601705,2587,1262,72518,331281,2555,1122,278812,1270424,32,140,194379,3610389,6504,50678,941377,1788,2,138,0,1,1120,1
Barnesiella_intestinihominis_62208,700024449,ERR911961,6433,2447814,348487,1588855,2591,1407,70521,320470,2562,1264,277966,1268385,29,143,194563,3603941,6651,48488,911356,1566,1,142,0,5,1258,1
Barnesiella_intestinihominis_62208,700024449,ERR911971,5499,2472564,352052,1604958,2250,1235,58022,263868,2218,1099,294030,1341090,32,136,205046,3811234,6990,40501,749750,1353,1,135,0,3,1095,1
Barnesiella_intestinihominis_62208,700024449,ERR912025,6419,2469268,351582,1602853,2608,1407,76484,345810,2582,1275,275098,1257043,26,132,192781,3571760,6588,52505,983200,1725,1,131,0,2,1272,1
Barnesiella_intestinihominis_62208,700024449,ERR912124,6181,2465124,350926,1600089,2493,1331,70411,321259,2467,1207,280515,1278830,26,124,195558,3634302,6630,49271,912862,1644,0,124,0,1,1205,1
Barnesiella_intestinihominis_62208,700024449,ERR912154,6917,2466040,351071,1600680,2802,1556,79324,360046,2777,1436,271747,1240634,25,120,190250,3525190,6462,54711,1023597,1830,0,120,0,1,1434,1
Barnesiella_intestinihominis_62208,700024615,700033502,2807,2441490,347273,1584765,1066,731,30402,136501,1034,596,316871,1448264,32,135,222079,4115213,7500,20621,388252,630,5,130,0,0,596,0
Barnesiella_intestinihominis_62208,700024615,ERR911970,1730,2445019,347742,1587032,668,477,14552,64927,635,378,333190,1522105,33,99,233176,4325159,7980,9879,184614,288,5,94,0,0,378,0
Barnesiella_intestinihominis_62208,700024615,ERR912013,491,2421340,344639,1571516,167,155,3875,17164,148,101,340764,1554352,19,54,238111,4416773,8172,2542,48893,57,4,50,0,0,101,0
Barnesiella_intestinihominis_62208,700024615,ERR912021,2739,2441087,347239,1584503,1048,734,25571,114784,1017,595,321668,1469719,31,139,225422,4176031,7704,17194,326651,507,6,133,0,1,594,0
Barnesiella_intestinihominis_62208,700024615,ERR912032,3953,2441411,347265,1584649,1516,1009,40749,183258,1478,834,306516,1401391,38,175,215024,3981808,7341,27697,521186,891,8,167,0,2,832,0
Barnesiella_intestinihominis_62208,700024615,ERR912062,3450,2443284,347490,1585947,1397,817,32974,148626,1371,720,314516,1437321,26,97,220383,4084065,7515,22517,422638,723,6,91,0,1,719,0
Barnesiella_intestinihominis_62208,700024615,ERR912090,3119,2440620,347112,1584212,1216,785,29480,134010,1185,662,317632,1450202,31,123,222231,4120770,7605,20416,380987,627,6,117,0,4,658,0
Barnesiella_intestinihominis_62208,700024615,ERR912135,3955,2441540,347301,1584753,1566,966,45419,203777,1534,852,301882,1380976,32,114,211782,3923883,7263,30938,579424,969,4,110,0,1,851,0
Barnesiella_intestinihominis_62208,700024615,ERR912194,4122,2439534,346975,1583459,1654,974,46781,211197,1619,865,300194,1372262,35,109,210570,3899019,7197,31956,600597,1038,4,105,0,1,863,1
Barnesiella_intestinihominis_62208,700024673,700037405,4822,2456484,349619,1594429,1906,1140,56903,255633,1882,1019,292716,1338796,24,121,205504,3803483,7401,38508,727218,1173,2,119,0,4,1015,0
Barnesiella_intestinihominis_62208,700024673,ERR912091,6956,2483668,353798,1612169,2800,1608,76814,345203,2748,1443,276984,1266966,52,165,194574,3599376,6948,51888,982041,1680,0,164,1,5,1438,0
Barnesiella_intestinihominis_62208,700024673,ERR912161,7027,2483499,353761,1612071,2836,1616,78842,354713,2788,1463,274919,1257358,48,153,193141,3572021,6912,53308,1009118,1713,0,152,1,5,1457,1
Barnesiella_intestinihominis_62208,700024711,700113810,4007,2458807,350081,1595892,1633,875,47436,213599,1617,749,302645,1382293,16,126,212332,3927269,7278,31814,607909,1074,2,124,0,1,746,2
Barnesiella_intestinihominis_62208,700024711,ERR912110,4012,2460103,350229,1596742,1636,879,47434,213594,1618,750,302795,1383148,18,129,212483,3929647,7314,31837,607868,1077,2,127,0,1,746,3
Barnesiella_intestinihominis_62208,700024711,ERR912150,4020,2458973,350030,1596033,1639,884,47371,213343,1619,745,302659,1382690,20,139,212433,3928326,7311,31791,607173,1065,2,137,0,1,742,2
Barnesiella_intestinihominis_62208,700033435,700172813,4762,2453418,349055,1592472,1868,1103,51146,233423,1829,934,297909,1359049,39,169,207972,3861903,7272,35766,663321,1182,4,165,0,4,929,1
Barnesiella_intestinihominis_62208,700033435,ERR912012,5090,2463445,350503,1598988,2019,1178,55094,250333,1981,1006,295409,1348655,38,172,206674,3832070,7221,38182,711551,1266,3,168,1,7,998,1
Barnesiella_intestinihominis_62208,700033435,ERR912115,6625,2441155,346976,1584557,2659,1549,74481,338851,2619,1315,272495,1245706,40,234,191424,3538839,6855,51448,963551,1554,6,228,0,5,1310,0
Barnesiella_intestinihominis_62208,700033435,ERR912183,4790,2459959,349936,1596686,1923,1118,49806,225727,1871,949,300130,1370959,52,169,210431,3894943,7503,34142,642016,1023,3,166,0,2,947,0
Barnesiella_intestinihominis_62208,700033435,ERR912201,6938,2459278,349881,1596326,2799,1585,83783,379953,2761,1414,266098,1216373,38,171,187000,3455513,6606,57406,1080617,1836,3,168,0,8,1405,1
Barnesiella_intestinihominis_62208,700033435,pluto3-11-30-0_,5779,2460762,350115,1597367,2282,1341,66010,300992,2235,1127,284105,1296375,47,214,198814,3683264,7047,45710,855868,1398,4,210,0,6,1121,0
Barnesiella_intestinihominis_62208,700033502,ERR911970,1844,2469392,351593,1602931,684,497,19340,88866,655,370,332253,1514065,29,127,231745,4302632,7818,13515,252672,411,2,125,0,0,370,0
Barnesiella_intestinihominis_62208,700033502,ERR912013,2408,2445077,348376,1586997,925,617,25336,114283,893,499,323040,1472714,32,118,225453,4185060,7629,17353,324950,546,1,117,0,0,499,0
Barnesiella_intestinihominis_62208,700033502,ERR912021,2956,2465511,351070,1600446,1104,778,31305,142714,1075,616,319765,1457732,29,162,223286,4142341,7569,21536,405979,627,3,159,0,1,615,0
Barnesiella_intestinihominis_62208,700033502,ERR912032,3889,2465710,351102,1600504,1489,979,43141,195857,1457,799,307961,1404647,32,180,215509,3991163,7269,29419,557225,927,7,173,0,0,799,0
Barnesiella_intestinihominis_62208,700033502,ERR912062,3395,2467609,351317,1601806,1357,781,36411,166861,1331,660,314906,1434945,26,121,219807,4077621,7407,25301,474475,807,4,117,0,1,659,0
Barnesiella_intestinihominis_62208,700033502,ERR912090,3273,2465003,350938,1600104,1251,810,34361,157825,1220,654,316577,1442279,31,156,220910,4098445,7482,23959,448808,708,5,151,0,2,652,0
Barnesiella_intestinihominis_62208,700033502,ERR912135,3878,2466183,351181,1600817,1530,938,45791,207688,1502,811,305390,1393129,28,127,213511,3958655,7221,31443,590634,987,2,125,0,0,811,0
Barnesiella_intestinihominis_62208,700033502,ERR912194,4120,2464209,350868,1599538,1637,972,47887,217837,1608,850,302981,1381701,29,122,211897,3926051,7155,32869,619583,1059,2,120,0,0,849,1
Barnesiella_intestinihominis_62208,700033665,700034254,4387,2427558,346358,1575776,1742,946,52576,236424,1731,855,293782,1339352,11,91,205772,3805828,6456,35064,673110,1098,3,88,0,4,849,2
Barnesiella_intestinihominis_62208,700033665,700034926,5247,2427017,346203,1575395,2170,1135,58703,264970,2150,1030,287500,1310425,20,105,201144,3723798,6333,39690,754020,1200,2,103,0,4,1026,0
Barnesiella_intestinihominis_62208,700033665,700037916,341,2434557,347484,1580360,135,90,4030,18501,123,60,343454,1561859,12,30,238594,4439522,7461,2837,52525,141,1,29,0,1,59,0
Barnesiella_intestinihominis_62208,700033665,700095647,4915,2430969,346935,1578017,1965,1119,54237,245298,1940,1013,292698,1332719,25,106,204400,3787331,6426,36748,698012,1134,2,104,0,5,1008,0
Barnesiella_intestinihominis_62208,700033665,700105312,4905,2432376,347203,1578975,1995,1075,55390,249330,1971,968,291813,1329645,24,107,204089,3778357,6489,37153,709766,1071,2,105,0,4,964,0
Barnesiella_intestinihominis_62208,700033665,700161533,5067,2420357,345292,1571044,2053,1109,58927,267255,2046,1020,286365,1303789,7,89,200126,3704962,6279,39937,760607,1221,3,86,0,4,1016,0
Barnesiella_intestinihominis_62208,700033665,700173483,3672,2429815,346771,1577267,1478,797,44532,200317,1464,707,302239,1376950,14,90,211368,3912834,6648,29643,570390,918,4,86,0,3,702,2
Barnesiella_intestinihominis_62208,700033665,ERR911961,571,2434181,347414,1580149,227,143,5558,24437,221,103,341856,1555712,6,40,237933,4421733,7470,3464,69745,102,2,38,0,1,102,0
Barnesiella_intestinihominis_62208,700033665,ERR911971,5054,2434215,347417,1580148,2023,1147,55070,248502,2002,1016,292347,1331646,21,131,204104,3784366,6468,37327,707057,1122,3,128,0,5,1011,0
Barnesiella_intestinihominis_62208,700033665,ERR912025,5250,2431028,346942,1578108,2121,1185,59232,266092,2103,1073,287710,1312016,18,112,201459,3728145,6444,39709,757433,1134,2,110,0,4,1069,0
Barnesiella_intestinihominis_62208,700033665,ERR912124,5404,2426659,346286,1575205,2176,1203,62971,284780,2158,1088,283315,1290425,18,115,197665,3667376,6234,43020,810018,1302,2,113,0,3,1085,0
Barnesiella_intestinihominis_62208,700033665,ERR912154,5833,2428269,346520,1576236,2352,1335,67322,303122,2336,1232,279198,1273114,16,103,195584,3617545,6213,45309,862707,1350,2,101,0,3,1229,0
Barnesiella_intestinihominis_62208,700033989,700035533,5720,2443884,348343,1586292,2223,1350,62190,281478,2193,1213,286153,1304814,30,137,200329,3707468,6645,42369,800772,1293,2,135,0,6,1205,2
Barnesiella_intestinihominis_62208,700033989,700111156,4269,2443577,348407,1586138,1682,1004,47588,215057,1655,875,300819,1371081,27,129,210046,3896216,6981,32494,611696,981,2,127,0,1,872,2
Barnesiella_intestinihominis_62208,700033989,700113177,4800,2443450,348349,1586033,1883,1133,53034,240185,1844,996,295315,1345848,39,137,206157,3824511,6876,36414,683049,1092,3,134,0,4,990,2
Barnesiella_intestinihominis_62208,700033989,700114082,4431,2441349,347742,1584651,1722,1070,47765,215995,1690,925,299977,1368656,32,145,209722,3889352,6894,32846,614080,1059,3,142,0,2,922,1
Barnesiella_intestinihominis_62208,700033989,700164792,5053,2446734,348827,1588214,1959,1166,55087,247499,1922,1042,293740,1340715,37,124,205469,3809878,6798,37403,703918,1176,2,122,0,2,1039,1
Barnesiella_intestinihominis_62208,700033989,700165148,4384,2444051,348197,1586352,1718,1046,47799,216729,1693,882,300398,1369623,25,164,209667,3892245,6957,33111,616059,1017,2,162,0,0,881,1
Barnesiella_intestinihominis_62208,700033989,700173320,5108,2447242,348913,1588518,1977,1203,58097,262176,1938,1071,290816,1326342,39,132,203434,3768842,6750,39485,745861,1182,2,130,0,2,1068,1
Barnesiella_intestinihominis_62208,700033989,700175331,4363,2448013,348998,1589009,1699,1053,46436,210799,1667,869,302562,1378210,32,184,210883,3916775,6972,32141,599254,1002,2,182,0,0,868,1
Barnesiella_intestinihominis_62208,700033989,ERR912085,378,2450353,349368,1590553,134,117,3703,16814,126,86,345665,1573739,8,31,240812,4472494,7911,2408,47950,84,1,30,0,0,86,0
Barnesiella_intestinihominis_62208,700033989,ERR912097,4440,2447419,348900,1588616,1711,1050,49507,223178,1669,930,299393,1365438,42,120,209061,3880341,6912,33870,634599,1065,3,117,0,2,927,1
Barnesiella_intestinihominis_62208,700033989,ERR912144,412,2450294,349338,1590513,131,148,3705,16816,126,86,345633,1573697,5,62,240818,4472362,7911,2409,47955,84,1,61,0,0,86,0
Barnesiella_intestinihominis_62208,700033989,ERR912152,4453,2447694,348931,1588794,1703,1069,49316,222298,1664,934,299615,1366496,39,135,209232,3883347,6909,33733,632090,1071,2,133,0,2,931,1
Barnesiella_intestinihominis_62208,700033989,ERR912184,4604,2437832,347327,1582352,1781,1082,51702,232521,1743,958,295625,1349831,38,124,206853,3835827,6813,35300,661105,1158,2,122,0,2,955,1
Barnesiella_intestinihominis_62208,700034254,700034926,6139,2457368,349770,1595007,2543,1282,71576,325318,2520,1164,278194,1269689,23,118,194975,3607672,6420,49207,925043,1704,1,117,0,3,1159,2
Barnesiella_intestinihominis_62208,700034254,700037916,4303,2441172,347571,1584509,1705,937,51188,230849,1686,848,296383,1353660,19,89,208141,3845852,6987,34251,657162,1134,3,86,0,3,843,2
Barnesiella_intestinihominis_62208,700034254,700095647,5854,2461838,350541,1597993,2336,1271,67660,308057,2316,1151,282881,1289936,20,120,197928,3665331,6549,46628,875950,1593,1,119,0,3,1146,2
Barnesiella_intestinihominis_62208,700034254,700105312,5659,2463172,350789,1598895,2326,1197,67279,304327,2306,1070,283510,1294568,20,127,199025,3678010,6669,45603,865878,1500,1,126,0,2,1066,2
Barnesiella_intestinihominis_62208,700034254,700161533,5712,2453532,349338,1592567,2293,1224,66109,301955,2281,1117,283229,1290612,12,107,197990,3667348,6498,45681,858642,1542,2,105,0,2,1113,2
Barnesiella_intestinihominis_62208,700034254,700173483,1208,2465179,351046,1600211,469,251,13528,60780,460,215,337518,1539431,9,36,235892,4374517,7884,8935,173117,288,1,35,0,1,214,0
Barnesiella_intestinihominis_62208,700034254,ERR911961,4291,2440963,347542,1584402,1720,936,50322,226686,1704,835,297220,1357716,16,101,208779,3857364,7005,33622,645347,1089,4,97,0,3,830,2
Barnesiella_intestinihominis_62208,700034254,ERR911971,5895,2464602,350945,1599790,2356,1294,67593,307381,2333,1141,283352,1292409,23,153,198186,3672438,6603,46612,873953,1578,2,151,0,3,1136,2
Barnesiella_intestinihominis_62208,700034254,ERR912025,5998,2461802,350539,1598007,2452,1304,71342,322307,2437,1178,279197,1275700,15,126,196196,3624310,6594,48364,916982,1575,2,124,0,2,1174,2
Barnesiella_intestinihominis_62208,700034254,ERR912124,6165,2457142,349843,1594898,2487,1302,73957,336387,2466,1181,275886,1258511,21,121,193207,3575921,6405,50841,956601,1719,0,121,0,2,1177,2
Barnesiella_intestinihominis_62208,700034254,ERR912154,6709,2458462,350027,1595765,2678,1516,77595,351594,2663,1394,272432,1244171,15,122,191429,3534745,6339,52813,1000166,1803,1,121,0,1,1391,2
Barnesiella_intestinihominis_62208,700034794,700037868,1327,2435801,346511,1581110,531,327,15477,69266,517,255,331034,1511844,14,72,231882,4295793,7857,10356,197082,360,3,69,0,0,255,0
Barnesiella_intestinihominis_62208,700034794,700097688,6967,2455954,349526,1594140,2808,1605,73282,329246,2759,1396,276244,1264894,49,209,195097,3593117,6468,49014,937083,1641,4,204,1,6,1390,0
Barnesiella_intestinihominis_62208,700034794,ERR912043,1682,2455624,349358,1593855,674,420,17931,79716,659,333,331427,1514139,15,87,232283,4302328,7806,11885,226819,444,2,85,0,1,332,0
Barnesiella_intestinihominis_62208,700034794,ERR912170,1978,2457241,349626,1594986,792,480,23240,105064,770,396,326386,1489922,22,84,228243,4233834,7689,16012,298598,582,2,82,0,0,396,0
Barnesiella_intestinihominis_62208,700034926,700037916,5134,2442194,347511,1585141,2114,1126,57450,260231,2086,1014,290061,1324910,28,112,203570,3764260,6900,39058,740360,1275,2,110,0,4,1010,0
Barnesiella_intestinihominis_62208,700034926,700095647,5065,2463657,350618,1599143,2093,1124,54842,249338,2064,1020,295776,1349805,29,104,207145,3835319,6951,37697,709072,1245,0,104,0,3,1017,0
Barnesiella_intestinihominis_62208,700034926,700105312,5204,2464297,350744,1599617,2181,1135,57739,261183,2149,1026,293005,1338434,32,109,205608,3802722,6972,39256,743063,1230,0,109,0,1,1025,0
Barnesiella_intestinihominis_62208,700034926,700161533,5131,2451425,348823,1591138,2105,1149,55850,254492,2090,1056,292973,1336646,15,93,204929,3798205,6804,38621,723586,1269,1,92,0,3,1053,0
Barnesiella_intestinihominis_62208,700034926,700173483,5460,2460546,350141,1597102,2259,1145,62278,284134,2237,1026,287863,1312968,22,119,201352,3730859,6693,43140,807756,1506,2,117,0,2,1022,2
Barnesiella_intestinihominis_62208,700034926,ERR911961,5163,2443542,347656,1586065,2118,1152,56467,255970,2096,1032,291189,1330095,22,120,204363,3779001,6921,38409,728298,1203,3,117,0,4,1028,0
Barnesiella_intestinihominis_62208,700034926,ERR911971,5340,2466051,350959,1600696,2207,1198,54648,247430,2178,1067,296311,1353266,29,131,207491,3845296,7011,37526,703549,1215,1,130,0,3,1064,0
Barnesiella_intestinihominis_62208,700034926,ERR912025,5562,2462978,350508,1598747,2313,1249,61705,278597,2293,1142,288803,1320150,20,107,202876,3750653,6921,41921,792574,1296,1,106,0,1,1141,0
Barnesiella_intestinihominis_62208,700034926,ERR912124,5648,2461226,350190,1597556,2299,1237,62173,282750,2272,1115,288017,1314806,27,122,201496,3736157,6765,43061,803773,1416,0,122,0,2,1113,0
Barnesiella_intestinihominis_62208,700034926,ERR912154,5461,2462164,350315,1598153,2246,1242,61760,279396,2232,1144,288555,1318757,14,98,202794,3746646,6831,41910,794913,1365,0,98,0,2,1142,0
Barnesiella_intestinihominis_62208,700035533,700111156,3646,2457935,349992,1595348,1430,870,37780,171181,1397,734,312212,1424167,33,136,218628,4046343,7530,25540,487172,831,0,136,0,5,728,1
Barnesiella_intestinihominis_62208,700035533,700113177,3861,2458656,350065,1595791,1520,908,43363,197719,1481,782,306702,1398072,39,126,214359,3972471,7386,29925,562248,984,1,125,0,8,772,2
Barnesiella_intestinihominis_62208,700035533,700114082,3721,2455779,349325,1593888,1456,911,36616,165564,1419,756,312709,1428324,37,155,219354,4058160,7458,24833,470968,891,1,154,0,6,749,1
Barnesiella_intestinihominis_62208,700035533,700164792,4545,2457646,349923,1595208,1800,1039,49273,221152,1768,925,300650,1374056,32,114,210944,3903985,7239,33221,629101,1134,0,114,0,4,920,1
Barnesiella_intestinihominis_62208,700035533,700165148,3939,2457719,349689,1595115,1537,962,39336,179161,1511,794,310353,1415954,26,168,217178,4023223,7461,27156,509424,903,0,168,0,6,787,1
Barnesiella_intestinihominis_62208,700035533,700173320,4202,2460851,350386,1597218,1633,997,45979,207247,1598,879,304407,1389971,35,118,213516,3949083,7314,30948,589815,978,0,118,0,6,871,2
Barnesiella_intestinihominis_62208,700035533,700175331,3932,2462085,350540,1598022,1524,974,38297,174416,1494,788,312243,1423606,30,186,218269,4045079,7470,26357,495994,897,0,186,0,6,781,1
Barnesiella_intestinihominis_62208,700035533,ERR912085,5482,2450366,348861,1590453,2146,1285,59564,269779,2115,1156,289297,1320674,31,129,202687,3752306,7029,40785,767247,1305,1,128,0,6,1148,2
Barnesiella_intestinihominis_62208,700035533,ERR912097,3920,2457748,349868,1595252,1533,922,42470,190687,1497,820,307398,1404565,36,102,215516,3990823,7356,28653,542400,1008,1,101,0,4,815,1
Barnesiella_intestinihominis_62208,700035533,ERR912144,5497,2450526,348861,1590554,2139,1297,59375,268902,2107,1150,289486,1321652,32,147,202903,3755009,7044,40632,764778,1296,1,146,0,6,1142,2
Barnesiella_intestinihominis_62208,700035533,ERR912152,3942,2458348,349961,1595624,1530,941,42320,189913,1496,831,307641,1405711,34,110,215676,3994080,7377,28555,540191,993,0,110,0,4,826,1
Barnesiella_intestinihominis_62208,700035533,ERR912184,4065,2448298,348310,1589092,1599,949,44742,200361,1567,846,303568,1388731,32,103,213288,3945618,7287,30114,569892,1077,0,103,0,4,841,1
Barnesiella_intestinihominis_62208,700037852,ERR912005,5708,2468980,351500,1602636,2275,1338,65076,292357,2248,1216,286424,1310279,27,122,201471,3722427,6939,43843,831758,1470,0,122,0,5,1211,0
Barnesiella_intestinihominis_62208,700037868,700109564,1340,2443767,347909,1586280,541,327,15575,69703,525,260,332334,1516577,16,67,232411,4309430,7890,10408,198335,366,1,66,0,0,260,0
Barnesiella_intestinihominis_62208,700037868,ERR912043,2135,2438211,347005,1582604,843,536,23640,105490,826,448,323365,1477114,17,88,226635,4196997,7710,15773,300151,546,1,87,0,1,447,0
Barnesiella_intestinihominis_62208,700037868,ERR912170,2379,2440011,347289,1583861,947,573,27888,125937,928,490,319401,1457924,19,83,223258,4142888,7626,19248,357894,669,1,82,0,0,490,0
Barnesiella_intestinihominis_62208,700037916,700095647,4811,2446981,348349,1588269,1909,1106,53280,241884,1879,994,295069,1346385,30,112,206667,3825453,7035,36334,688121,1197,2,110,0,4,990,0
Barnesiella_intestinihominis_62208,700037916,700105312,4825,2448495,348638,1589320,1946,1081,55421,250188,1918,966,293217,1339132,28,115,205912,3804437,7047,37189,712193,1182,2,113,0,3,963,0
Barnesiella_intestinihominis_62208,700037916,700161533,4954,2434864,346603,1580351,1997,1095,57652,262384,1983,1005,288951,1317967,14,90,202470,3744630,6801,39247,746612,1293,3,87,0,3,1002,0
Barnesiella_intestinihominis_62208,700037916,700173483,3591,2446055,348221,1587663,1436,796,43444,196075,1422,709,304777,1391588,14,87,213738,3953706,7320,29108,558178,939,4,83,0,3,704,2
Barnesiella_intestinihominis_62208,700037916,ERR911961,490,2450233,348860,1590450,181,141,4363,19443,163,93,344497,1571007,18,48,240434,4464439,8148,2807,55435,87,1,47,0,0,93,0
Barnesiella_intestinihominis_62208,700037916,ERR911971,4947,2450221,348841,1590405,1955,1144,53671,243061,1931,1007,295170,1347344,24,137,206663,3828274,7095,36590,691426,1167,3,134,0,4,1003,0
Barnesiella_intestinihominis_62208,700037916,ERR912025,5184,2447111,348377,1588418,2078,1195,58035,261550,2051,1074,290342,1326868,27,121,203984,3769567,7053,39033,744402,1215,3,118,0,3,1071,0
Barnesiella_intestinihominis_62208,700037916,ERR912124,5279,2442573,347700,1585398,2109,1195,60549,274550,2087,1068,287151,1310848,22,127,201074,3724588,6882,41444,780868,1338,2,125,0,2,1066,0
Barnesiella_intestinihominis_62208,700037916,ERR912154,5832,2444312,347936,1586539,2348,1349,68196,308188,2330,1244,279740,1278351,18,105,196656,3631644,6753,46081,876974,1509,2,103,0,2,1242,0
Barnesiella_intestinihominis_62208,700038386,ERR912151,5184,2380650,336686,1545258,2059,1141,59290,273375,2030,1023,277396,1271883,29,118,196353,3612471,6825,41542,777344,1239,2,116,0,3,1020,0
Barnesiella_intestinihominis_62208,700038702,ERR912105,2819,2367699,337255,1536658,1110,665,30385,136894,1095,594,306870,1399764,15,71,214752,3977250,7290,20493,389469,720,0,71,0,3,591,0
Barnesiella_intestinihominis_62208,700038806,700123827,600,2481710,353387,1610861,232,151,6616,29766,219,102,346771,1581095,13,49,241794,4493055,8436,4581,84555,162,1,48,0,0,102,0
Barnesiella_intestinihominis_62208,700095486,ERR911993,3840,2436067,347046,1581104,1539,888,46671,210693,1528,804,300375,1370411,11,84,210105,3893982,7146,31970,599020,1089,0,84,0,1,802,1
Barnesiella_intestinihominis_62208,700095486,ERR911995,3337,2440559,347701,1584003,1343,769,41577,189797,1331,687,306124,1394206,12,82,213429,3962019,7170,29050,539264,1077,1,81,0,2,684,1
Barnesiella_intestinihominis_62208,700095647,700105312,4875,2468774,351517,1602555,1997,1107,54769,247721,1967,992,296748,1354834,30,115,207823,3849626,7053,37399,704561,1203,0,115,0,3,989,0
Barnesiella_intestinihominis_62208,700095647,700161533,4590,2455306,349516,1593676,1853,1018,53688,245852,1842,930,295828,1347824,11,88,206384,3830185,6903,37482,698841,1233,0,88,0,4,926,0
Barnesiella_intestinihominis_62208,700095647,700173483,4974,2465686,351025,1600486,2002,1091,57353,262266,1979,972,293672,1338220,23,119,204957,3802851,6852,39953,745447,1398,2,117,0,2,968,2
Barnesiella_intestinihominis_62208,700095647,ERR911961,4929,2446332,348244,1587893,1955,1152,52766,239442,1930,1025,295478,1348451,25,127,206967,3831330,7056,35975,681226,1125,3,124,0,4,1021,0
Barnesiella_intestinihominis_62208,700095647,ERR911971,1747,2472013,351942,1604614,683,473,17175,77631,666,398,334767,1526983,17,75,233513,4339516,7920,12009,220485,399,1,74,0,2,396,0
Barnesiella_intestinihominis_62208,700095647,ERR912025,5205,2467625,351310,1601795,2116,1218,59901,270753,2093,1095,291409,1331042,23,123,204245,3781888,6993,40920,770049,1290,1,122,0,3,1092,0
Barnesiella_intestinihominis_62208,700095647,ERR912124,4420,2464479,350791,1599686,1747,1019,50660,230301,1724,897,300131,1369385,23,122,209613,3891420,7122,35184,654558,1161,0,122,0,2,895,0
Barnesiella_intestinihominis_62208,700095647,ERR912154,5926,2464340,350781,1599602,2400,1358,66227,300949,2378,1260,284554,1298653,22,98,199347,3689862,6750,45480,855864,1503,0,98,0,2,1258,0
Barnesiella_intestinihominis_62208,700097631,ERR912187,2497,2402624,342505,1559504,961,640,31803,143212,934,513,310702,1416292,27,127,216806,4024693,7377,21684,407277,675,1,125,1,0,512,1
Barnesiella_intestinihominis_62208,700097688,700109564,7026,2463719,350916,1599207,2830,1618,73825,331303,2783,1416,277091,1267904,47,202,195386,3601840,6486,49257,943005,1647,2,199,1,6,1410,0
Barnesiella_intestinihominis_62208,700097688,700171573,2717,2459817,349951,1596657,1085,640,27037,123581,1057,529,322914,1473076,28,111,225654,4186119,7455,18831,351225,687,2,109,0,3,526,0
Barnesiella_intestinihominis_62208,700103558,700116611,7198,2469137,351736,1602717,2896,1729,79859,359723,2856,1554,271877,1242994,40,175,190854,3531615,6513,54324,1023033,1812,1,174,0,5,1547,2
Barnesiella_intestinihominis_62208,700103558,700165167,2942,2398295,343601,1557035,1139,725,30337,136952,1108,621,313264,1420083,31,104,217153,4036130,6966,20644,389621,591,1,103,0,2,619,0
Barnesiella_intestinihominis_62208,700105312,700161533,4873,2457334,349873,1595046,1970,1089,55594,253225,1952,980,294279,1341821,18,109,205908,3812652,6903,38078,720382,1215,1,108,0,2,978,0
Barnesiella_intestinihominis_62208,700105312,700173483,4929,2467950,351433,1602002,2028,1042,57282,260007,1999,911,294151,1341995,29,131,205977,3813021,6987,39096,739635,1290,2,129,0,2,907,2
Barnesiella_intestinihominis_62208,700105312,ERR911961,4905,2447841,348555,1588928,1979,1107,53800,242865,1951,984,294755,1346063,28,123,206855,3824215,7119,36158,691357,1080,3,120,0,3,981,0
Barnesiella_intestinihominis_62208,700105312,ERR911971,4972,2472561,352101,1605011,2032,1132,53736,242047,2007,997,298365,1362964,25,135,208978,3872759,7155,36529,688460,1152,1,134,0,3,994,0
Barnesiella_intestinihominis_62208,700105312,ERR912025,504,2471762,351972,1604534,190,164,5102,22539,185,135,346870,1581995,5,29,242040,4495713,8232,3462,64071,84,1,28,0,0,135,0
Barnesiella_intestinihominis_62208,700105312,ERR912124,5516,2464888,350970,1599992,2236,1214,61873,280165,2205,1079,289097,1319827,31,135,202233,3750327,6921,42545,796624,1326,0,135,0,1,1078,0
Barnesiella_intestinihominis_62208,700105312,ERR912154,5885,2465772,351081,1600578,2396,1356,66872,301219,2379,1239,284209,1299359,17,117,199861,3691412,6804,45053,857143,1461,0,117,0,1,1238,0
Barnesiella_intestinihominis_62208,700106412,700116611,7187,2466897,351418,1601285,2896,1719,79219,356774,2858,1542,272199,1244511,38,177,191062,3535928,6543,53819,1014703,1800,1,176,0,5,1536,1
Barnesiella_intestinihominis_62208,700106412,700165167,2937,2397718,343468,1556701,1136,720,30290,136748,1103,612,313178,1419953,33,108,217102,4035752,7005,20607,389046,591,1,107,0,2,610,0
Barnesiella_intestinihominis_62208,700109564,ERR912043,1689,2463905,350840,1599236,680,418,18027,80100,666,340,332813,1519136,14,78,232814,4316734,7860,11952,227898,450,0,78,0,1,339,0
Barnesiella_intestinihominis_62208,700109564,ERR912170,1998,2465783,351149,1600558,803,478,24460,110884,785,403,326689,1489674,18,75,227914,4233410,7698,16940,315091,621,0,75,0,1,402,0
Barnesiella_intestinihominis_62208,700111156,700113177,2632,2458027,350096,1595426,1077,647,27640,124394,1037,509,322456,1471032,40,138,225405,4179858,7833,18674,353929,579,1,137,0,3,505,1
Barnesiella_intestinihominis_62208,700111156,700114082,1176,2457043,349562,1594749,472,296,12851,57268,447,204,336711,1537481,25,92,235644,4368654,8145,8582,162949,273,1,90,1,1,203,0
Barnesiella_intestinihominis_62208,700111156,700164792,2976,2457145,349941,1594955,1192,704,31751,141467,1157,583,318190,1453488,35,121,222670,4130105,7689,21312,402345,744,0,121,0,1,582,0
Barnesiella_intestinihominis_62208,700111156,700165148,1376,2458604,349881,1595723,558,342,17381,79080,543,233,332500,1516643,15,109,232239,4309641,8049,12081,224817,342,0,109,0,1,232,0
Barnesiella_intestinihominis_62208,700111156,700173320,2861,2460776,350493,1597239,1110,704,31558,140851,1067,574,318935,1456388,43,130,223340,4138171,7653,20987,400891,675,0,130,0,1,572,1
Barnesiella_intestinihominis_62208,700111156,700175331,1374,2463933,350896,1599284,556,347,16477,74917,538,222,334419,1524367,18,125,233311,4331720,8070,11368,213047,336,0,125,0,1,221,0
Barnesiella_intestinihominis_62208,700111156,ERR912085,3953,2450772,349042,1590772,1565,930,43789,198081,1532,795,305253,1392691,33,135,213287,3957316,7470,30096,563205,942,1,134,0,1,791,3
Barnesiella_intestinihominis_62208,700111156,ERR912097,2215,2457478,349970,1595110,877,549,24240,107811,837,431,325730,1487299,40,118,227696,4226356,7845,16314,306531,588,1,116,1,1,430,0
Barnesiella_intestinihominis_62208,700111156,ERR912144,3973,2451046,349057,1590949,1558,945,43804,198230,1528,794,305253,1392719,30,151,213304,3957398,7455,30141,563598,951,1,150,0,1,790,3
Barnesiella_intestinihominis_62208,700111156,ERR912152,2231,2457963,350024,1595446,874,565,24160,107464,835,438,325864,1487982,39,127,227820,4228269,7857,16246,305564,582,0,126,1,1,437,0
Barnesiella_intestinihominis_62208,700111156,ERR912184,2393,2447796,348384,1588791,960,578,27125,120393,924,458,321259,1468398,36,120,224995,4172456,7743,18230,342262,687,0,119,1,1,457,0
Barnesiella_intestinihominis_62208,700113177,700114082,2844,2455190,349312,1593531,1140,721,27170,121888,1093,564,322142,1471643,47,157,225706,4181486,7737,18369,346644,651,1,156,0,5,558,1
Barnesiella_intestinihominis_62208,700113177,700164792,3696,2457981,350033,1595468,1500,866,40194,179446,1456,753,309839,1416022,44,113,217022,4023535,7509,27082,510332,924,1,112,0,4,748,1
Barnesiella_intestinihominis_62208,700113177,700165148,2778,2457162,349654,1594758,1118,719,28095,127613,1084,550,321559,1467145,34,169,224675,4168990,7770,19544,362665,630,1,168,0,4,545,1
Barnesiella_intestinihominis_62208,700113177,700173320,3273,2461889,350636,1597944,1307,805,35622,159063,1257,685,315014,1438881,50,120,220611,4088406,7626,23849,452632,708,1,119,0,4,679,2
Barnesiella_intestinihominis_62208,700113177,700175331,2745,2462259,350644,1598160,1099,721,28086,127428,1063,530,322558,1470732,36,191,225187,4179215,7794,19368,362295,621,1,190,0,4,525,1
Barnesiella_intestinihominis_62208,700113177,ERR912085,4485,2450876,349034,1590819,1767,1058,50065,226630,1730,924,298969,1364189,37,134,208981,3876248,7338,34470,644376,1044,2,132,0,4,918,2
Barnesiella_intestinihominis_62208,700113177,ERR912097,2967,2458384,350047,1595711,1201,716,31904,142369,1153,608,318143,1453342,48,108,222568,4129793,7665,21572,404782,753,2,106,0,4,603,1
Barnesiella_intestinihominis_62208,700113177,ERR912144,4491,2450931,349011,1590841,1756,1067,49715,225147,1720,916,299296,1365694,36,151,209155,3880577,7350,34344,640047,1050,2,149,0,4,910,2
Barnesiella_intestinihominis_62208,700113177,ERR912152,2980,2458613,350094,1595834,1194,733,31868,142144,1148,618,318226,1453690,46,115,222640,4130756,7674,21532,404144,756,1,114,0,4,613,1
Barnesiella_intestinihominis_62208,700113177,ERR912184,3127,2448742,348478,1589381,1271,745,34200,152132,1226,632,314278,1437249,45,113,220306,4083854,7587,23041,432524,831,1,112,0,4,627,1
Barnesiella_intestinihominis_62208,700114082,700164792,3152,2454267,349159,1593002,1245,764,31807,141386,1206,616,317352,1451616,39,148,222560,4124677,7611,21418,401945,795,1,147,0,2,614,0
Barnesiella_intestinihominis_62208,700114082,700165148,1574,2457136,349315,1594754,626,392,15580,70287,607,275,333735,1524467,19,117,233544,4331841,8016,10852,199628,381,1,116,0,2,273,0
Barnesiella_intestinihominis_62208,700114082,700173320,3028,2457690,349667,1595166,1191,753,31257,139268,1151,602,318410,1455898,40,151,223490,4136632,7572,20811,396258,735,1,150,0,2,599,1
Barnesiella_intestinihominis_62208,700114082,700175331,1552,2460881,350057,1597241,608,400,14547,65703,586,269,335510,1531538,22,131,234542,4352044,8028,10100,186649,360,1,130,0,2,267,0
Barnesiella_intestinihominis_62208,700114082,ERR912085,4114,2448278,348302,1589099,1605,994,43924,198884,1565,842,304378,1390215,40,152,213046,3950231,7368,30359,565273,1020,2,150,0,2,839,1
Barnesiella_intestinihominis_62208,700114082,ERR912097,2459,2454822,349191,1593345,956,618,23877,105954,911,473,325314,1487391,45,145,227859,4226541,7773,16169,301039,654,2,143,0,2,471,0
Barnesiella_intestinihominis_62208,700114082,ERR912144,4148,2449110,348397,1589643,1602,1014,44098,199556,1565,845,304299,1390087,37,169,213037,3949877,7347,30499,567134,1035,2,167,0,2,842,1
Barnesiella_intestinihominis_62208,700114082,ERR912152,2469,2455401,349280,1593715,953,632,23911,106135,910,479,325369,1487580,43,153,227914,4227047,7779,16175,301588,642,1,152,0,2,477,0
Barnesiella_intestinihominis_62208,700114082,ERR912184,2622,2445597,347684,1587307,1028,648,27196,120182,990,509,320488,1467125,38,139,224969,4168762,7644,18308,341464,774,1,138,0,2,507,0
Barnesiella_intestinihominis_62208,700116611,700165167,7973,2392723,342842,1553406,3244,1857,85781,385444,3201,1702,257061,1167962,43,155,179000,3319123,5763,58221,1096305,1806,0,155,0,5,1697,0
Barnesiella_intestinihominis_62208,700161533,700173483,5000,2457693,349904,1595282,2017,1079,57030,261773,2005,966,292874,1333509,12,113,204188,3789547,6792,39841,744131,1347,3,110,0,1,963,2
Barnesiella_intestinihominis_62208,700161533,ERR911961,5063,2434619,346557,1580217,2031,1134,57034,259566,2022,1032,289523,1320651,9,102,202859,3752263,6831,38827,738623,1248,4,98,0,3,1029,0
Barnesiella_intestinihominis_62208,700161533,ERR911971,4845,2459012,350066,1596089,1940,1118,53842,245503,1929,1000,296224,1350586,11,118,206736,3838056,6966,37412,697906,1191,1,117,0,4,996,0
Barnesiella_intestinihominis_62208,700161533,ERR912025,5243,2456258,349647,1594363,2114,1201,60151,273248,2101,1086,289496,1321115,13,115,202754,3753718,6873,41181,777273,1290,1,114,0,2,1084,0
Barnesiella_intestinihominis_62208,700161533,ERR912124,5451,2452330,349075,1591723,2146,1216,62430,285900,2133,1104,286645,1305823,13,112,199756,3711005,6708,43740,812535,1425,1,111,0,1,1103,0
Barnesiella_intestinihominis_62208,700161533,ERR912154,5649,2452498,349054,1591833,2255,1324,63423,289445,2245,1245,285631,1302388,10,79,199615,3700838,6711,43956,822954,1425,1,78,0,1,1244,0
Barnesiella_intestinihominis_62208,700164792,700165148,3310,2456079,349485,1594130,1304,791,34780,156275,1278,633,314705,1437855,26,158,220211,4085749,7605,23887,444134,804,0,158,0,2,631,0
Barnesiella_intestinihominis_62208,700164792,700173320,3620,2460094,350349,1596840,1430,843,41667,185613,1413,762,308682,1411227,17,81,216360,4009935,7386,27919,527960,960,0,81,0,2,759,1
Barnesiella_intestinihominis_62208,700164792,700175331,3283,2461045,350450,1597457,1288,796,33801,151936,1258,620,316649,1445521,30,176,221291,4107679,7593,23136,431859,813,0,176,0,2,618,0
Barnesiella_intestinihominis_62208,700164792,ERR912085,4882,2454259,349521,1593045,1892,1130,53740,242008,1851,1010,295781,1351037,41,120,207058,3838877,7176,36690,688110,1224,1,119,0,2,1007,1
Barnesiella_intestinihominis_62208,700164792,ERR912097,1142,2462370,350624,1598326,452,244,12472,56468,443,210,338152,1541858,9,34,235880,4381552,8142,8638,160463,303,1,33,0,0,210,0
Barnesiella_intestinihominis_62208,700164792,ERR912144,4911,2454608,349547,1593277,1887,1155,53557,241184,1846,1017,295990,1352093,41,138,207210,3841875,7194,36618,685722,1212,1,137,0,2,1014,1
Barnesiella_intestinihominis_62208,700164792,ERR912152,1134,2463007,350729,1598722,440,256,11316,51546,432,210,339413,1547176,8,46,236695,4396637,8196,7891,146495,252,0,46,0,0,210,0
Barnesiella_intestinihominis_62208,700164792,ERR912184,1292,2452751,349059,1592036,518,266,13712,61733,512,234,335347,1530303,6,32,234329,4348483,8097,9420,175446,333,0,32,0,0,234,0
Barnesiella_intestinihominis_62208,700165148,700173320,3188,2459701,350036,1596418,1242,791,34144,153475,1212,633,315892,1442943,30,158,221220,4100025,7584,23212,436460,753,0,158,0,2,630,1
Barnesiella_intestinihominis_62208,700165148,700175331,219,2464020,350590,1599245,77,83,1930,8648,74,33,348660,1590597,3,50,243452,4519984,8355,1449,24441,54,0,50,0,0,33,0
Barnesiella_intestinihominis_62208,700165148,ERR912085,4063,2450091,348631,1590226,1603,963,44450,201976,1575,806,304181,1388250,28,157,212497,3944858,7395,31035,573912,981,1,156,0,0,805,1
Barnesiella_intestinihominis_62208,700165148,ERR912097,2536,2456770,349546,1594554,991,634,27061,121616,962,481,322485,1472938,29,153,225489,4185576,7749,18668,345520,660,1,152,0,2,479,0
Barnesiella_intestinihominis_62208,700165148,ERR912144,4091,2450406,348652,1590417,1593,985,43792,199018,1562,799,304860,1391399,31,186,212981,3953809,7407,30606,565476,972,1,185,0,0,798,1
Barnesiella_intestinihominis_62208,700165148,ERR912152,2541,2457106,349607,1594756,980,651,26853,120552,953,487,322754,1474204,27,164,225670,4189175,7767,18517,342482,657,0,164,0,2,485,0
Barnesiella_intestinihominis_62208,700165148,ERR912184,2761,2447074,347968,1588214,1079,679,29775,133535,1053,527,318193,1454679,26,152,222840,4133547,7650,20524,379325,756,0,152,0,2,525,0
Barnesiella_intestinihominis_62208,700171114,ERR912100,686,2462396,350217,1598343,249,178,6136,29178,230,119,344081,1569165,19,59,240364,4458764,8367,4449,82947,138,7,52,0,2,117,0
Barnesiella_intestinihominis_62208,700171114,ERR912148,645,2462323,350194,1598333,242,159,6125,29122,231,117,344069,1569211,11,42,240386,4458889,8358,4438,82793,135,3,39,0,2,115,0
Barnesiella_intestinihominis_62208,700171114,ERR912190,2026,2461655,350117,1597883,779,510,19506,88710,754,402,330611,1509173,25,108,231390,4288053,8076,13331,252385,414,4,104,0,1,401,0
Barnesiella_intestinihominis_62208,700172813,ERR911981,7476,2451579,349000,1591332,2944,1688,84382,381786,2904,1476,264618,1209546,40,212,185350,3436889,6399,58106,1085206,2046,3,209,0,6,1468,2
Barnesiella_intestinihominis_62208,700172813,ERR912012,1188,2468315,351467,1602179,456,330,12562,56685,437,217,338905,1545494,19,113,236496,4391715,8271,8492,161287,276,2,110,1,2,215,0
Barnesiella_intestinihominis_62208,700172813,ERR912115,6415,2437643,346765,1582241,2550,1469,72933,331196,2519,1247,273832,1251045,31,222,191830,3554585,6720,50427,941442,1719,4,218,0,5,1241,1
Barnesiella_intestinihominis_62208,700172813,ERR912145,4838,2459010,350072,1596102,1894,1135,51267,234003,1856,959,298805,1362099,38,176,208327,3870671,7299,35855,664954,1200,4,172,0,4,954,1
Barnesiella_intestinihominis_62208,700172813,ERR912183,4679,2455819,349669,1593974,1911,1077,48319,218841,1870,917,301350,1375133,41,160,210527,3907507,7365,33340,622001,1182,2,158,0,3,913,1
Barnesiella_intestinihominis_62208,700172813,ERR912201,6889,2454714,349541,1593330,2767,1535,78184,353612,2737,1365,271357,1239718,30,170,190159,3522419,6576,53518,1005422,1896,3,167,0,6,1357,2
Barnesiella_intestinihominis_62208,700172813,pluto3-11-30-0_,5526,2456905,349858,1594826,2163,1232,63794,290295,2128,1020,286064,1304531,35,212,199705,3706979,6909,44198,825127,1560,3,209,0,5,1014,1
Barnesiella_intestinihominis_62208,700173320,700175331,3162,2464470,350979,1599600,1225,797,32874,148025,1190,618,318105,1451575,35,179,222422,4124701,7602,22323,421008,744,0,179,0,2,615,1
Barnesiella_intestinihominis_62208,700173320,ERR912085,4794,2454404,349587,1593123,1865,1125,54441,245733,1822,988,295146,1347390,43,137,206596,3828407,7167,37141,698906,1152,1,136,0,2,984,2
Barnesiella_intestinihominis_62208,700173320,ERR912097,2933,2460922,350426,1597359,1142,702,33806,150246,1121,625,316620,1447113,21,77,221692,4112120,7527,22661,427267,810,0,77,0,3,621,1
Barnesiella_intestinihominis_62208,700173320,ERR912144,4816,2454448,349563,1593141,1857,1145,54588,246434,1816,988,294975,1346707,41,157,206497,3826451,7173,37280,700876,1146,1,156,0,2,984,2
Barnesiella_intestinihominis_62208,700173320,ERR912152,2957,2461166,350491,1597484,1141,720,34097,151653,1120,628,316394,1445831,21,92,221519,4108423,7551,22872,431280,807,0,92,0,2,626,0
Barnesiella_intestinihominis_62208,700173320,ERR912184,3116,2451347,348868,1591092,1221,738,36821,163226,1202,661,312047,1427866,19,77,218991,4057146,7461,24597,464193,888,0,77,0,2,658,1
Barnesiella_intestinihominis_62208,700173483,ERR911961,3681,2445270,348126,1587200,1468,824,42128,190111,1453,722,305998,1397089,15,102,214570,3969365,7332,28198,541262,873,5,97,0,2,718,2
Barnesiella_intestinihominis_62208,700173483,ERR911971,5015,2469578,351616,1603022,2017,1121,56714,258944,1992,969,294902,1344078,25,152,205686,3819603,6945,39545,735925,1362,3,149,0,3,964,2
Barnesiella_intestinihominis_62208,700173483,ERR912025,5262,2466532,351153,1601073,2154,1145,60994,276190,2136,1016,290159,1324883,18,129,203445,3764259,6945,41551,785663,1356,3,126,0,1,1013,2
Barnesiella_intestinihominis_62208,700173483,ERR912124,5428,2461845,350470,1597958,2193,1166,63957,291780,2170,1028,286513,1306178,23,138,200071,3711740,6723,44410,829391,1539,1,137,0,1,1025,2
Barnesiella_intestinihominis_62208,700173483,ERR912154,5985,2463017,350624,1598712,2397,1359,68387,310795,2384,1239,282237,1287917,13,120,197785,3659297,6669,46858,883922,1605,2,118,0,0,1237,2
Barnesiella_intestinihominis_62208,700175331,ERR912085,4047,2455095,349610,1593571,1584,974,43060,195787,1549,794,306550,1397784,35,180,213847,3972086,7419,30010,556379,972,1,179,0,0,793,1
Barnesiella_intestinihominis_62208,700175331,ERR912097,2521,2461644,350509,1597802,980,641,25862,116162,945,469,324647,1481640,35,172,226692,4210467,7761,17774,330052,660,1,171,0,2,467,0
Barnesiella_intestinihominis_62208,700175331,ERR912144,4077,2455178,349604,1593618,1575,996,43117,195979,1541,794,306487,1397639,34,202,213816,3971652,7449,30095,556891,951,1,201,0,0,793,1
Barnesiella_intestinihominis_62208,700175331,ERR912152,2524,2462139,350586,1598122,970,655,25752,115612,938,477,324834,1482510,32,178,226841,4212925,7764,17692,328484,660,0,178,0,2,475,0
Barnesiella_intestinihominis_62208,700175331,ERR912184,2740,2452031,348930,1591516,1065,684,28585,128062,1034,512,320345,1463454,31,172,224066,4158625,7671,19628,363808,750,0,172,0,2,510,0
Barnesiella_intestinihominis_62208,ERR911961,ERR911971,5079,2450336,348873,1590506,2014,1181,53249,240884,1993,1035,295624,1349622,21,146,206999,3834742,7125,36261,685284,1107,4,142,0,4,1031,0
Barnesiella_intestinihominis_62208,ERR911961,ERR912025,5266,2447009,348384,1588379,2113,1223,57651,259868,2089,1093,290733,1328511,24,130,204202,3774257,7074,38800,739643,1161,4,126,0,3,1090,0
Barnesiella_intestinihominis_62208,ERR911961,ERR912124,5224,2445051,348014,1587047,2097,1190,59157,268571,2076,1054,288857,1318476,21,136,202123,3746390,6915,40628,763822,1263,3,133,0,2,1052,0
Barnesiella_intestinihominis_62208,ERR911961,ERR912154,5812,2446191,348199,1587781,2343,1349,65507,296109,2325,1232,282692,1291672,18,117,198598,3669629,6789,44319,842592,1416,3,114,0,2,1230,0
Barnesiella_intestinihominis_62208,ERR911967,ERR912112,2685,2478601,353032,1608845,1059,676,29897,135673,1020,559,323135,1473172,39,117,225878,4185769,7869,20274,386082,663,4,113,0,3,556,0
Barnesiella_intestinihominis_62208,ERR911967,ERR912131,137,2481690,353477,1610888,51,49,2598,11831,37,5,350879,1599057,14,44,244594,4544051,8526,1788,33651,54,2,42,0,0,5,0
Barnesiella_intestinihominis_62208,ERR911967,ERR912164,2741,2479205,353146,1609243,1093,678,30596,138880,1053,562,322550,1470363,40,116,225454,4177796,7839,20680,395267,693,5,111,0,2,560,0
Barnesiella_intestinihominis_62208,ERR911970,ERR912013,1341,2450490,349155,1590469,523,374,11070,49465,491,287,338085,1541004,32,87,235741,4379138,8133,7564,140597,234,1,86,0,0,287,0
Barnesiella_intestinihominis_62208,ERR911970,ERR912021,2052,2470845,351846,1603865,778,569,18499,84477,751,431,333347,1519388,27,138,232608,4317543,8013,12719,240352,360,3,135,0,1,429,1
Barnesiella_intestinihominis_62208,ERR911970,ERR912032,3300,2471329,351925,1604126,1284,836,34085,154706,1249,666,317840,1449420,35,170,222158,4118473,7629,23293,440087,738,7,163,0,0,666,0
Barnesiella_intestinihominis_62208,ERR911970,ERR912062,1904,2473577,352190,1605654,785,421,19612,89040,770,351,332578,1516614,15,70,232248,4309668,7926,13427,253222,471,2,68,0,1,350,0
Barnesiella_intestinihominis_62208,ERR911970,ERR912090,2450,2470222,351707,1603457,951,624,22510,104273,923,496,329197,1499184,28,128,229406,4260256,7890,15949,296399,471,4,124,0,3,493,0
Barnesiella_intestinihominis_62208,ERR911970,ERR912135,3325,2471451,351929,1604218,1341,794,38033,172334,1311,686,313896,1431884,30,108,219373,4068704,7575,26093,490102,807,2,106,0,0,686,0
Barnesiella_intestinihominis_62208,ERR911970,ERR912194,3554,2469532,351620,1602989,1441,835,40561,184604,1412,735,311059,1418385,29,100,217424,4030231,7500,27841,525083,888,2,98,0,0,734,1
Barnesiella_intestinihominis_62208,ERR911971,ERR912025,5244,2471786,351942,1604507,2133,1214,57020,256534,2109,1076,294922,1347973,24,138,206765,3830014,7140,38732,729664,1206,2,136,0,3,1073,0
Barnesiella_intestinihominis_62208,ERR911971,ERR912124,4477,2467823,351332,1601863,1756,1065,49329,223707,1736,915,302003,1378156,20,150,210775,3916487,7206,34289,635743,1089,1,149,0,2,913,0
Barnesiella_intestinihominis_62208,ERR911971,ERR912154,6225,2468618,351449,1602393,2532,1456,67266,304721,2514,1328,284183,1297672,18,128,199063,3687152,6801,46109,866539,1515,1,127,0,2,1326,0
Barnesiella_intestinihominis_62208,ERR911981,ERR912115,3754,2449008,348309,1589707,1562,861,39876,180191,1548,775,308433,1409516,14,86,216219,4004811,7518,27321,512289,963,2,84,0,2,772,1
Barnesiella_intestinihominis_62208,ERR911981,ERR912183,7255,2458317,349930,1595704,2878,1649,79860,362083,2834,1445,270070,1233621,44,204,188920,3505241,6702,55379,1029043,1827,3,201,0,5,1439,1
Barnesiella_intestinihominis_62208,ERR911981,ERR912201,5777,2464846,350919,1599990,2350,1307,64780,290676,2326,1201,286139,1309314,24,106,201314,3719692,6936,43529,826939,1560,0,106,0,4,1195,2
Barnesiella_intestinihominis_62208,ERR911981,pluto3-11-30-0_,2929,2467560,351310,1601808,1191,641,32532,147008,1180,583,318778,1454800,11,58,222824,4133911,7665,22262,417928,834,1,57,0,2,580,1
Barnesiella_intestinihominis_62208,ERR911993,ERR911995,3100,2457590,350058,1595182,1228,758,36647,164361,1215,671,313411,1430821,13,87,219215,4065796,7452,24906,467274,903,1,86,0,3,668,0
Barnesiella_intestinihominis_62208,ERR912003,ERR912175,2043,2465599,351018,1600412,783,504,23421,105770,771,445,327597,1494642,12,59,228794,4247218,7914,16064,300772,474,2,57,0,0,445,0
Barnesiella_intestinihominis_62208,ERR912012,ERR912115,6508,2448039,348265,1589009,2613,1483,72940,330554,2578,1241,275325,1258455,35,242,193136,3575434,6795,50255,939730,1677,3,238,1,4,1236,1
Barnesiella_intestinihominis_62208,ERR912012,ERR912145,5177,2469252,351568,1602748,2050,1212,55420,251611,2011,1026,296148,1351137,39,186,206934,3839199,7278,38366,715210,1257,3,182,1,7,1018,1
Barnesiella_intestinihominis_62208,ERR912012,ERR912183,4884,2466269,351176,1600759,2002,1135,50880,229421,1964,967,300296,1371338,38,168,210238,3896387,7389,34775,652291,1197,2,165,1,5,961,1
Barnesiella_intestinihominis_62208,ERR912012,ERR912201,7245,2464335,350926,1599601,2943,1626,83188,375142,2910,1439,267738,1224459,33,187,188160,3478671,6546,56578,1066904,1944,1,185,1,8,1429,2
Barnesiella_intestinihominis_62208,ERR912012,pluto3-11-30-0_,5815,2467201,351340,1601522,2309,1308,65733,298173,2273,1077,285607,1303349,36,231,199771,3703301,6975,45233,847765,1521,2,228,1,5,1071,1
Barnesiella_intestinihominis_62208,ERR912013,ERR912021,2376,2446050,348572,1587620,904,656,22054,98282,874,522,326518,1489338,30,134,228036,4232121,7857,14781,279612,453,2,132,0,1,521,0
Barnesiella_intestinihominis_62208,ERR912013,ERR912032,3658,2446507,348641,1587835,1416,937,37781,169046,1378,771,310860,1418789,38,166,217546,4031333,7488,25416,480891,831,5,161,0,1,770,0
Barnesiella_intestinihominis_62208,ERR912013,ERR912062,3073,2448591,348897,1589264,1253,720,29484,133112,1227,636,319413,1456152,26,84,222971,4137826,7659,20196,378465,675,3,81,0,1,635,0
Barnesiella_intestinihominis_62208,ERR912013,ERR912090,2776,2445953,348478,1587553,1077,715,26177,118515,1050,592,322301,1469038,27,123,224845,4174520,7749,18077,336898,570,3,120,0,3,589,0
Barnesiella_intestinihominis_62208,ERR912013,ERR912135,3656,2446593,348645,1587908,1468,891,41518,185824,1432,786,307127,1402084,36,105,214842,3983955,7455,28117,528473,882,1,104,0,0,786,0
Barnesiella_intestinihominis_62208,ERR912013,ERR912194,3872,2444710,348353,1586698,1571,915,44206,198770,1537,818,304147,1387928,34,97,212813,3943621,7350,29950,565385,975,1,96,0,0,817,1
Barnesiella_intestinihominis_62208,ERR912021,ERR912032,4173,2466956,351352,1601293,1598,1092,44208,199559,1568,874,307144,1401734,30,218,215162,3982639,7401,29809,567953,915,8,210,0,1,873,0
Barnesiella_intestinihominis_62208,ERR912021,ERR912062,3653,2468905,351590,1602628,1460,871,36376,165811,1437,743,315214,1436817,23,128,220173,4082727,7551,24990,471660,783,5,123,0,2,741,0
Barnesiella_intestinihominis_62208,ERR912021,ERR912090,902,2467402,351371,1601649,319,264,7718,36249,304,164,343653,1565400,15,100,239333,4448707,8160,5705,102883,159,3,97,0,2,162,0
Barnesiella_intestinihominis_62208,ERR912021,ERR912135,4172,2467110,351373,1601428,1636,1039,47217,212804,1610,889,304156,1388624,26,150,212888,3945631,7353,32092,605342,978,3,147,0,1,888,0
Barnesiella_intestinihominis_62208,ERR912021,ERR912194,4424,2465288,351081,1600240,1756,1081,49044,222628,1729,933,302037,1377612,27,148,211368,3914172,7296,33420,633414,1050,3,145,0,1,931,1
Barnesiella_intestinihominis_62208,ERR912025,ERR912124,5885,2464007,350793,1599418,2374,1329,66074,298566,2350,1195,284719,1300852,24,134,199362,3696309,6885,45374,848926,1398,1,133,0,1,1194,0
Barnesiella_intestinihominis_62208,ERR912025,ERR912154,6239,2464908,350888,1600001,2527,1468,70433,316916,2514,1348,280455,1283085,13,120,197397,3645063,6795,47487,901749,1512,1,119,0,1,1347,0
Barnesiella_intestinihominis_62208,ERR912032,ERR912062,4838,2469430,351665,1602899,1954,1124,51357,233959,1921,963,300308,1368940,33,161,209822,3889822,7176,35499,665223,1155,8,153,0,2,961,0
Barnesiella_intestinihominis_62208,ERR912032,ERR912090,4563,2466830,351295,1601208,1761,1151,48181,219148,1732,954,303114,1382060,29,197,212061,3926838,7281,32996,623416,1032,9,188,0,3,951,0
Barnesiella_intestinihominis_62208,ERR912032,ERR912135,1036,2472206,352068,1604661,364,297,10713,48068,346,186,341355,1556593,18,111,238302,4423344,8133,7255,136730,219,7,104,0,0,186,0
Barnesiella_intestinihominis_62208,ERR912032,ERR912194,1039,2470392,351778,1603498,393,277,11975,54109,376,160,339803,1549389,17,117,237335,4402759,8073,8058,153978,291,7,110,0,0,159,1
Barnesiella_intestinihominis_62208,ERR912043,ERR912170,2839,2461196,350382,1597505,1140,697,31918,143197,1117,600,318464,1454308,23,97,222811,4132568,7545,21752,407044,795,0,96,1,2,598,0
Barnesiella_intestinihominis_62208,ERR912048,ERR912095,2144,2466387,351241,1600873,810,542,23044,105182,783,433,328197,1495691,27,109,228600,4250478,7995,16188,298827,531,1,108,0,1,432,0
Barnesiella_intestinihominis_62208,ERR912062,ERR912090,4031,2468449,351475,1602327,1621,927,40034,184160,1596,801,311441,1418167,25,126,217217,4029832,7452,28023,523572,885,6,120,0,4,797,0
Barnesiella_intestinihominis_62208,ERR912062,ERR912135,4838,2469388,351660,1602888,1999,1067,54987,250197,1972,966,296673,1352691,27,101,207235,3843707,7131,38074,711293,1224,4,97,0,1,965,0
Barnesiella_intestinihominis_62208,ERR912062,ERR912194,5103,2467657,351376,1601783,2113,1126,58260,265730,2087,1028,293116,1336053,26,98,204794,3796324,7041,40325,755536,1329,4,94,0,1,1026,1
Barnesiella_intestinihominis_62208,ERR912066,ERR912133,2797,2388470,340525,1550208,1103,701,29536,133744,1074,594,310989,1416464,29,107,216861,4025115,7416,20110,380480,642,6,101,0,4,590,0
Barnesiella_intestinihominis_62208,ERR912085,ERR912097,4227,2455952,349726,1594128,1633,996,47258,213267,1589,884,302468,1380861,44,112,211376,3923881,7326,32511,606201,1089,2,110,0,2,881,1
Barnesiella_intestinihominis_62208,ERR912085,ERR912152,4241,2455969,349740,1594120,1626,1015,47030,212297,1584,882,302710,1381823,42,133,211573,3926564,7332,32356,603443,1092,1,132,0,2,879,1
Barnesiella_intestinihominis_62208,ERR912085,ERR912184,4395,2446378,348161,1587857,1703,1031,49472,222844,1662,913,298689,1365013,41,118,209138,3878668,7233,33979,633377,1176,1,117,0,2,910,1
Barnesiella_intestinihominis_62208,ERR912090,ERR912135,4555,2466982,351302,1601325,1791,1098,51177,232317,1766,967,300125,1369008,25,131,209747,3890029,7248,35307,660549,1095,3,128,0,4,963,0
Barnesiella_intestinihominis_62208,ERR912090,ERR912194,4817,2465071,350986,1600087,1916,1140,53126,242759,1890,1007,297860,1357328,26,133,208117,3856682,7185,36752,690367,1158,4,129,0,3,1003,1
Barnesiella_intestinihominis_62208,ERR912091,ERR912161,74,2499212,356002,1622366,39,10,1356,6232,35,6,354646,1616134,4,4,247086,4592622,8694,924,17748,24,0,4,0,0,6,0
Barnesiella_intestinihominis_62208,ERR912097,ERR912144,4249,2455707,349660,1593974,1625,1016,47193,213058,1581,881,302467,1380916,44,135,211422,3924009,7317,32504,605569,1101,2,133,0,2,878,1
Barnesiella_intestinihominis_62208,ERR912097,ERR912152,77,2464127,350834,1599440,21,33,1191,5079,17,6,349643,1594361,4,27,243924,4530753,8406,766,14423,48,1,26,0,0,6,0
Barnesiella_intestinihominis_62208,ERR912097,ERR912184,510,2454430,349256,1593104,207,112,6310,28337,200,86,342946,1564767,7,26,239349,4446729,8223,4530,80253,228,1,25,0,0,86,0
Barnesiella_intestinihominis_62208,ERR912100,ERR912190,2154,2473963,352399,1605888,826,506,20942,96341,796,393,331457,1509547,30,113,231059,4289530,8052,14511,274080,432,7,106,0,2,391,0
Barnesiella_intestinihominis_62208,ERR912112,ERR912131,2699,2478744,353029,1608951,1085,639,32297,146835,1066,559,320732,1462116,19,80,224142,4154373,7833,22014,417780,711,2,78,0,3,556,0
Barnesiella_intestinihominis_62208,ERR912112,ERR912164,99,2479429,353142,1609398,39,28,694,2999,35,9,352448,1606399,4,19,245777,4564867,8553,388,8591,18,1,18,0,0,9,0
Barnesiella_intestinihominis_62208,ERR912115,ERR912145,6716,2447078,348036,1588407,2695,1569,74579,338912,2654,1332,273457,1249495,41,237,191919,3549642,6924,51413,963790,1533,5,232,0,6,1326,0
Barnesiella_intestinihominis_62208,ERR912115,ERR912183,6499,2444227,347641,1586529,2644,1494,69890,317044,2597,1265,277751,1269485,47,229,194807,3606631,7017,48274,901361,1497,4,225,0,4,1261,0
Barnesiella_intestinihominis_62208,ERR912115,ERR912201,4861,2450697,348629,1590756,2004,1118,53465,240649,1987,994,295164,1350107,17,124,207738,3835362,7221,35880,684795,1272,3,121,0,3,990,1
Barnesiella_intestinihominis_62208,ERR912115,pluto3-11-30-0_,1707,2453616,349042,1592712,713,410,17315,79840,703,330,331727,1512872,10,80,231880,4298636,8100,11993,227131,396,3,77,0,2,328,0
Barnesiella_intestinihominis_62208,ERR912124,ERR912154,6482,2466379,351070,1600915,2589,1491,73552,334371,2571,1379,277518,1266544,18,112,194115,3598929,6588,50842,950579,1692,0,112,0,0,1379,0
Barnesiella_intestinihominis_62208,ERR912131,ERR912164,2756,2479513,353162,1609473,1120,641,33521,152323,1097,560,319641,1457150,23,81,223462,4140182,7806,22699,433529,741,3,78,0,2,558,0
Barnesiella_intestinihominis_62208,ERR912135,ERR912194,1150,2470388,351783,1603510,438,276,13758,62730,426,230,338025,1540780,12,46,235777,4378448,8115,9565,178349,276,2,44,0,0,229,1
Barnesiella_intestinihominis_62208,ERR912144,ERR912152,4263,2456272,349745,1594328,1617,1033,47072,212491,1578,889,302673,1381837,39,144,211545,3926640,7326,32441,603940,1092,1,143,0,2,886,1
Barnesiella_intestinihominis_62208,ERR912144,ERR912184,4420,2446368,348132,1587839,1695,1051,49468,222696,1656,910,298664,1365143,39,141,209178,3879018,7233,33995,632908,1185,1,140,0,2,907,1
Barnesiella_intestinihominis_62208,ERR912145,ERR912183,4873,2466249,351052,1600781,1947,1151,50975,230859,1895,973,300077,1369922,52,178,210232,3891989,7545,34852,656690,1035,3,175,0,2,971,0
Barnesiella_intestinihominis_62208,ERR912145,ERR912201,7060,2465510,350979,1600400,2847,1619,82072,371786,2808,1432,268907,1228614,39,187,188841,3490296,6705,56071,1057499,1788,2,185,0,9,1422,1
Barnesiella_intestinihominis_62208,ERR912145,pluto3-11-30-0_,5862,2466298,351115,1600966,2314,1359,66779,304560,2267,1135,284336,1296406,47,224,198751,3683393,7074,46208,866056,1416,4,220,0,6,1129,0
Barnesiella_intestinihominis_62208,ERR912148,ERR912190,2127,2473877,352371,1605852,823,490,20741,95436,798,395,331630,1510416,25,95,231192,4291998,8058,14363,271531,414,3,92,0,1,394,0
Barnesiella_intestinihominis_62208,ERR912152,ERR912184,491,2454392,349257,1593057,188,121,4927,22407,183,81,344330,1570650,5,40,240270,4463400,8280,3626,63427,168,0,40,0,0,81,0
Barnesiella_intestinihominis_62208,ERR912183,ERR912201,6802,2462651,350596,1598499,2777,1508,79451,357538,2732,1325,271145,1240961,45,183,190720,3525386,6777,53913,1016940,1761,2,181,0,6,1318,1
Barnesiella_intestinihominis_62208,ERR912183,pluto3-11-30-0_,5649,2463237,350706,1598950,2270,1266,62565,284121,2223,1046,288141,1314829,47,220,201384,3735915,7188,43286,807733,1344,3,217,0,4,1042,0
Barnesiella_intestinihominis_62208,ERR912201,pluto3-11-30-0_,3887,2469669,351652,1603149,1555,891,45173,202390,1540,789,306479,1400759,15,102,215081,3979819,7377,30127,575900,1143,2,100,0,1,787,1
Barnesiella_intestinihominis_62208,SRR2822459,ERR912003,4341,2459886,350247,1596715,1764,1002,48038,217215,1737,903,302209,1379500,27,99,211733,3919474,7293,32617,618008,1020,3,96,0,1,902,0
Barnesiella_intestinihominis_62208,SRR2822459,ERR912175,5352,2458333,349998,1595697,2158,1236,59998,271334,2138,1132,290000,1324363,20,104,203654,3762409,7026,40555,772145,1302,4,100,0,1,1131,0
