species_name,sample 1,sample 2,core_diff,core_len,core_len_4D,core_len_1D,core_diff_4D,core_diff_1D,recomb_len_4D,recomb_len_1D,recomb_diff_4D,recomb_diff_1D,clonal_len_4D,clonal_len_1D,clonal_diff_4D,clonal_diff_1D,clonal_n,clonal_m,clonal_nn,recomb_n,recomb_m,recomb_nn,clonal_mut_n,clonal_mut_m,clonal_mut_nn,recomb_mut_n,recomb_mut_m,recomb_mut_nn
Dialister_invisus_61905,700015415,ERR911972,4156,1207211,185778,790229,1876,923,39852,165576,1848,856,145926,624653,28,67,84699,1785126,4134,20383,475262,1083,0,67,0,3,852,1
Dialister_invisus_61905,700015415,ERR911992,3976,1208432,185994,791126,1801,854,39723,161979,1774,793,146271,629147,27,61,85750,1797512,4179,19471,465407,1059,0,61,0,1,791,1
Dialister_invisus_61905,700015415,ERR912099,5082,1210317,186251,792281,2296,1058,46899,190474,2272,999,139352,601807,24,59,82936,1718450,4035,22505,547738,1179,1,58,0,3,995,1
Dialister_invisus_61905,700015702,700016765,3954,1211173,186468,792855,1753,863,40938,168225,1735,785,145530,624630,18,78,84879,1784856,4155,20573,483061,1041,0,78,0,2,782,1
Dialister_invisus_61905,700015702,700024318,4601,1214993,187244,795384,2006,1071,48137,200574,1977,992,139107,594810,29,79,80782,1699739,3909,24917,575491,1314,1,77,1,3,987,2
Dialister_invisus_61905,700015702,700037868,5010,1213886,187048,794654,2226,1128,51285,212302,2210,1045,135763,582352,16,83,79213,1663967,3876,26401,609167,1338,2,81,0,3,1041,1
Dialister_invisus_61905,700015702,700163419,4336,1214879,187311,795353,1891,1006,45120,185437,1873,948,142191,609916,18,58,82950,1742838,3960,22633,532457,1221,0,58,0,2,945,1
Dialister_invisus_61905,700015702,700164735,5510,1215718,187500,795900,2397,1302,54901,227014,2378,1221,132599,568886,19,81,77470,1625456,3732,28180,651401,1461,0,80,1,3,1217,1
Dialister_invisus_61905,700015702,700172279,4355,1216472,187514,796403,1900,1019,45228,186883,1882,957,142286,609520,18,62,82734,1741818,4008,23064,536382,1203,2,60,0,2,953,2
Dialister_invisus_61905,700015702,ERR911957,4749,1212337,186845,793689,2139,1043,50855,207830,2112,973,135990,585859,27,70,80422,1673300,3855,25074,597069,1347,0,70,0,4,967,2
Dialister_invisus_61905,700015702,ERR912152,5262,1208882,186312,791329,2379,1117,51578,211667,2361,1060,134734,579662,18,57,79614,1655580,3792,25582,608039,1380,1,56,0,4,1054,2
Dialister_invisus_61905,700016765,700024318,2951,1218720,187576,797767,1273,691,29286,122354,1250,618,158290,675413,23,73,90914,1930780,4545,15106,351209,747,0,72,1,3,614,1
Dialister_invisus_61905,700016765,700035785,3583,1211290,186349,792901,1576,763,33345,136453,1561,692,153004,656448,15,71,88951,1875992,4401,16507,392018,834,0,71,0,2,690,0
Dialister_invisus_61905,700016765,700037868,2579,1217599,187339,797052,1094,611,21940,92025,1078,534,165399,705027,16,77,94359,2015985,4737,11592,263934,549,2,75,0,0,534,0
Dialister_invisus_61905,700016765,700163419,2429,1215828,187122,795909,1011,551,19583,80331,992,498,167539,715578,19,53,96176,2045830,4728,9600,230898,495,1,52,0,1,497,0
Dialister_invisus_61905,700016765,700164735,4045,1215345,187110,795569,1740,948,32800,136138,1720,888,154310,659431,20,60,88957,1884950,4386,16754,390814,846,1,58,1,2,886,0
Dialister_invisus_61905,700016765,700172279,3247,1215073,186962,795390,1392,758,28529,118101,1376,684,158433,677289,16,74,91545,1935804,4518,14232,339351,720,2,72,0,1,682,1
Dialister_invisus_61905,700016765,ERR911953,3496,1212539,186578,793693,1539,752,30030,125083,1526,703,156548,668610,13,49,90353,1911040,4437,15159,359289,801,2,47,0,3,700,0
Dialister_invisus_61905,700016765,ERR911957,2249,1213425,186713,794293,1008,465,24107,97430,984,399,162606,696863,24,66,94481,1991467,4641,11194,280493,603,1,65,0,1,397,1
Dialister_invisus_61905,700016765,ERR911976,3217,1216446,187217,796293,1420,718,29976,123214,1399,651,157241,673079,21,67,90957,1923780,4500,14899,353963,780,1,65,1,4,647,0
Dialister_invisus_61905,700016765,ERR911987,3758,1214427,186892,794960,1595,902,35190,147600,1576,836,151702,647360,19,66,86600,1851193,4287,19114,422747,939,0,65,1,1,834,1
Dialister_invisus_61905,700016765,ERR912028,2977,1215205,186968,795446,1320,685,28067,115468,1289,599,158901,679978,31,86,91775,1943653,4506,14094,331548,762,2,84,0,1,598,0
Dialister_invisus_61905,700016765,ERR912029,3761,1211146,186376,792808,1630,867,35120,146402,1605,800,151256,646406,25,67,87391,1847570,4257,18077,420205,924,2,65,0,5,791,4
Dialister_invisus_61905,700016765,ERR912085,3189,1214540,186930,795027,1323,778,30430,126500,1299,706,156500,668527,24,72,90317,1910944,4320,15399,363165,936,0,72,0,3,703,0
Dialister_invisus_61905,700016765,ERR912115,4000,1217152,187359,796742,1751,931,36881,152529,1710,853,150478,644213,41,78,87059,1841359,4221,18804,437769,1014,0,78,0,3,850,0
Dialister_invisus_61905,700016765,ERR912121,3165,1211720,186418,793162,1375,718,26301,108552,1353,631,160117,684610,22,87,92233,1957082,4515,13327,311624,705,3,84,0,3,627,1
Dialister_invisus_61905,700016765,ERR912133,3293,1216930,187315,796596,1423,771,32158,135024,1401,714,155157,661572,22,57,88924,1891409,4383,16953,387240,879,1,56,0,3,709,2
Dialister_invisus_61905,700016765,ERR912152,2326,1210601,186277,792358,1033,484,21190,87494,1015,424,165087,704864,18,60,95126,2014858,4608,10275,251604,603,2,58,0,3,420,1
Dialister_invisus_61905,700021295,700163030,2651,1215401,186954,795672,1191,617,24709,103217,1155,532,162245,692455,36,85,92905,1979993,4467,12960,295893,798,2,83,0,1,530,1
Dialister_invisus_61905,700021295,700164417,1897,1222613,188451,800488,855,445,13981,57572,820,373,174470,742916,35,72,99340,2124503,4905,6860,165478,378,1,71,0,1,371,1
Dialister_invisus_61905,700021361,ERR912034,4648,1222967,188418,800627,2093,1032,38957,160190,2060,922,149461,640437,33,110,87179,1829881,4251,19063,460544,963,0,110,0,3,916,3
Dialister_invisus_61905,700023578,700023788,2678,1215995,187010,795947,1197,634,27471,113369,1175,564,159539,682578,22,70,92095,1951082,4557,13855,325544,708,0,70,0,1,562,1
Dialister_invisus_61905,700023578,700099512,2719,1221372,187698,799493,1182,670,29873,124764,1163,598,157825,674729,19,72,90804,1928934,4449,15639,357816,837,0,72,0,3,595,0
Dialister_invisus_61905,700023788,700099512,2998,1216591,187006,796408,1281,724,28840,119114,1263,657,158166,677294,18,67,91284,1936125,4473,14660,341899,783,0,67,0,4,652,1
Dialister_invisus_61905,700024318,700035785,5030,1213289,186789,794216,2173,1155,49742,206591,2159,1071,137047,587625,14,84,80080,1678817,3978,25505,592972,1296,0,83,1,3,1067,1
Dialister_invisus_61905,700024318,700037868,4497,1220051,187838,798655,1956,1060,42199,176481,1935,964,145639,622174,21,96,83995,1778273,4254,22126,506228,1089,2,93,1,3,960,1
Dialister_invisus_61905,700024318,700163419,4027,1219399,187810,798278,1717,939,37569,155777,1697,872,150241,642501,20,67,86997,1836186,4320,19015,447362,954,1,65,1,2,869,1
Dialister_invisus_61905,700024318,700164735,4905,1219851,187957,798571,2105,1189,45707,189597,2083,1106,142250,608974,22,83,82539,1740246,4137,23498,544153,1140,1,82,0,3,1102,1
Dialister_invisus_61905,700024318,700172279,4522,1218541,187626,797681,1906,1127,41730,174303,1890,1051,145896,623378,16,76,84483,1781439,4212,21518,500305,1086,2,74,0,2,1048,1
Dialister_invisus_61905,700024318,ERR911953,4712,1216241,187267,796125,2020,1104,45821,191939,2005,1033,141446,604186,15,71,81990,1726497,4071,23814,550776,1227,2,68,1,4,1028,1
Dialister_invisus_61905,700024318,ERR911957,3688,1216336,187287,796216,1643,851,36800,152097,1616,770,150487,644119,27,81,87536,1840447,4374,18360,437001,930,1,79,1,4,764,2
Dialister_invisus_61905,700024318,ERR911976,4567,1220488,187960,798959,1981,1085,44184,183953,1964,1004,143776,615006,17,81,83511,1757283,4224,22657,528089,1113,1,80,0,5,998,1
Dialister_invisus_61905,700024318,ERR911987,5363,1217638,187529,797085,2278,1303,52189,219189,2267,1213,135340,577896,11,90,77846,1651948,3894,28072,628100,1395,0,90,0,2,1209,2
Dialister_invisus_61905,700024318,ERR912028,3721,1220978,187967,799267,1639,887,39311,164159,1606,768,148656,635108,33,119,85716,1815321,4287,20559,470877,1041,2,115,2,2,766,0
Dialister_invisus_61905,700024318,ERR912029,4633,1214928,187084,795323,2002,1116,45092,187441,1983,1056,141992,607882,19,60,82690,1736939,4017,23072,538036,1215,1,59,0,8,1046,2
Dialister_invisus_61905,700024318,ERR912085,4526,1219047,187765,797994,1888,1114,44846,187700,1868,1024,142919,610294,20,90,82839,1744002,4041,23204,538621,1275,0,89,1,3,1020,1
Dialister_invisus_61905,700024318,ERR912115,5298,1222401,188306,800225,2257,1306,53099,221147,2233,1230,135207,579078,24,76,78597,1654803,3834,27651,634326,1464,0,75,1,4,1225,1
Dialister_invisus_61905,700024318,ERR912121,4679,1215248,187090,795499,2033,1122,42756,178470,2016,1040,144334,617029,17,82,83660,1763290,4137,22168,512117,1125,3,78,1,4,1034,2
Dialister_invisus_61905,700024318,ERR912133,4343,1220735,188010,799098,1851,1089,44144,185883,1833,1017,143866,613215,18,72,82482,1753023,4140,23685,532782,1182,1,70,1,4,1012,1
Dialister_invisus_61905,700024318,ERR912152,4244,1213355,186810,794188,1875,953,39160,162797,1855,876,147650,631391,20,77,85826,1804144,4203,19764,467559,1068,2,74,1,4,872,0
Dialister_invisus_61905,700034254,ERR912033,2024,1235871,190461,809161,890,478,18363,73621,865,421,172098,735540,25,57,98613,2103120,4887,8685,211740,438,0,57,0,0,421,0
Dialister_invisus_61905,700035785,700037868,4795,1213410,186747,794333,2112,1110,45080,186192,2098,1015,141667,608141,14,95,82526,1737751,4146,23064,534381,1131,1,94,0,3,1012,0
Dialister_invisus_61905,700035785,700163419,4273,1213323,186812,794317,1874,969,37325,152865,1861,895,149487,641452,13,74,87058,1833011,4287,18446,439210,939,1,73,0,1,894,0
Dialister_invisus_61905,700035785,700164735,5479,1213244,186887,794218,2377,1274,48415,199093,2363,1188,138472,595125,14,86,81302,1700065,4008,24178,571892,1209,1,84,1,3,1185,0
Dialister_invisus_61905,700035785,700172279,4442,1214859,187062,795284,1927,1044,43012,177415,1916,960,144050,617869,11,84,83913,1765539,4155,21739,509423,1083,1,83,0,1,958,1
Dialister_invisus_61905,700035785,ERR911953,5845,1209579,186213,791758,2541,1292,53471,221291,2531,1226,132742,570467,10,66,78260,1629295,3846,26984,635503,1386,2,64,0,3,1223,0
Dialister_invisus_61905,700035785,ERR911957,4353,1210821,186409,792584,1944,940,42470,173361,1927,859,143939,619223,17,81,84561,1768977,4131,20837,498142,1104,1,80,0,3,855,1
Dialister_invisus_61905,700035785,ERR911976,4942,1214495,187011,795028,2165,1140,45917,189052,2153,1064,141094,605976,12,76,82657,1731221,4050,22994,542944,1218,1,75,0,4,1059,1
Dialister_invisus_61905,700035785,ERR911987,5153,1212756,186778,793891,2196,1224,51270,213030,2185,1150,135508,580861,11,74,78337,1660340,3906,27151,610619,1320,0,73,1,1,1148,1
Dialister_invisus_61905,700035785,ERR912028,5021,1211974,186546,793363,2192,1158,51156,211673,2175,1058,135390,581690,17,100,79011,1662159,3900,26533,607136,1350,2,98,0,1,1057,0
Dialister_invisus_61905,700035785,ERR912029,5526,1208850,186130,791317,2419,1259,50513,209582,2408,1189,135617,581735,11,70,79308,1662039,3858,25928,601489,1329,2,68,0,5,1180,4
Dialister_invisus_61905,700035785,ERR912085,5405,1212375,186700,793599,2278,1313,51648,213088,2267,1235,135052,580511,11,78,79410,1658382,3741,26075,611671,1518,0,78,0,3,1232,0
Dialister_invisus_61905,700035785,ERR912115,5753,1215101,187155,795425,2492,1316,53060,219565,2470,1246,134095,575860,22,70,78384,1645371,3825,27253,630017,1425,0,70,0,3,1243,0
Dialister_invisus_61905,700035785,ERR912121,4688,1210429,186307,792333,2067,1080,44155,181795,2054,983,142152,610538,13,97,83090,1744474,4050,22302,521922,1161,3,94,0,3,979,1
Dialister_invisus_61905,700035785,ERR912133,5481,1213401,186854,794315,2383,1275,53041,219965,2371,1209,133813,574350,12,66,78129,1641105,3816,27415,631052,1428,1,65,0,3,1204,2
Dialister_invisus_61905,700035785,ERR912152,4774,1207624,185888,790439,2149,1005,43679,179293,2136,933,142209,611146,13,72,83587,1745777,4074,21539,515188,1152,1,71,0,3,929,1
Dialister_invisus_61905,700037868,700163419,3495,1219124,187748,798085,1499,826,28665,119316,1476,740,159083,678769,23,86,91183,1940600,4524,14822,342367,759,3,83,0,1,739,0
Dialister_invisus_61905,700037868,700164735,4435,1218866,187780,797904,1923,1054,39002,163329,1908,971,148778,634575,15,83,85336,1814129,4260,20617,468359,1011,2,80,1,3,968,0
Dialister_invisus_61905,700037868,700172279,4195,1218870,187662,797906,1807,1022,37879,158011,1788,919,149783,639895,19,103,86388,1829010,4287,19650,453375,1008,4,99,0,1,917,1
Dialister_invisus_61905,700037868,ERR911953,4781,1215281,187113,795512,2056,1082,39818,165533,2032,994,147295,629979,24,88,85445,1800220,4272,20245,475334,1020,1,87,0,6,988,0
Dialister_invisus_61905,700037868,ERR911957,3756,1216257,187256,796169,1630,863,34429,141237,1604,772,152827,654932,26,91,88755,1871622,4419,17111,405721,879,3,88,0,1,770,1
Dialister_invisus_61905,700037868,ERR911976,4819,1219349,187779,798219,2062,1131,42308,175583,2045,1036,145471,622636,17,95,84299,1779370,4239,21758,503884,1107,3,91,1,4,1032,0
Dialister_invisus_61905,700037868,ERR911987,5002,1217463,187501,796996,2118,1213,47199,198687,2110,1132,140302,598309,8,81,80192,1710670,4065,25716,569112,1233,2,78,1,1,1130,1
Dialister_invisus_61905,700037868,ERR912028,4132,1218738,187592,797820,1782,987,39370,163472,1751,884,148222,634348,31,103,85738,1812986,4320,20408,468997,1011,4,99,0,1,883,0
Dialister_invisus_61905,700037868,ERR912029,4967,1213936,186929,794664,2087,1243,47014,196772,2061,1151,139915,597892,26,92,80873,1708822,3981,24792,564279,1245,3,89,0,6,1141,4
Dialister_invisus_61905,700037868,ERR912085,4858,1217786,187518,797185,2049,1196,45542,190738,2038,1128,141976,606447,11,68,82169,1733191,3981,23799,547071,1344,1,67,0,4,1124,0
Dialister_invisus_61905,700037868,ERR912115,5463,1220642,188004,799046,2313,1345,48717,203759,2282,1237,139287,595287,31,108,80324,1701562,3975,25797,584151,1329,2,106,0,3,1234,0
Dialister_invisus_61905,700037868,ERR912121,4052,1215665,187135,795790,1734,970,34843,145381,1710,859,152292,650409,24,111,87595,1859297,4335,18264,416949,930,4,107,0,4,854,1
Dialister_invisus_61905,700037868,ERR912133,4767,1219963,187873,798618,2042,1170,44207,185808,2025,1095,143666,612810,17,75,82419,1751871,4140,23665,532577,1182,2,73,0,4,1089,2
Dialister_invisus_61905,700037868,ERR912152,3656,1213387,186824,794224,1550,845,32341,134917,1529,747,154483,659307,21,98,88929,1884591,4401,16656,387216,879,5,93,0,2,744,1
Dialister_invisus_61905,700100600,ERR911969,3703,1207864,185676,790665,1668,813,35473,147394,1628,701,150203,643271,40,112,87197,1838254,4362,18177,423150,855,2,110,0,4,697,0
Dialister_invisus_61905,700100600,ERR912127,3749,1212029,186477,793351,1652,843,34927,144578,1614,745,151550,648773,38,98,88179,1853844,4296,17420,415372,942,2,96,0,2,743,0
Dialister_invisus_61905,700163030,700164417,2365,1219340,187587,798310,1099,513,22044,91190,1073,457,165543,707120,26,56,94872,2021862,4626,11309,261595,666,3,53,0,0,455,2
Dialister_invisus_61905,700163419,700164735,4425,1221079,188203,799401,1901,1015,37515,154781,1888,953,150688,644620,13,62,87241,1842365,4254,18780,444570,993,0,61,1,2,951,0
Dialister_invisus_61905,700163419,700172279,3440,1220408,188000,798960,1430,867,30676,127251,1418,784,157324,671709,12,83,90606,1920099,4422,15451,365471,831,2,81,0,0,783,1
Dialister_invisus_61905,700163419,ERR911953,4932,1216456,187389,796335,2125,1088,42275,174822,2113,1040,145114,621513,12,48,84723,1775655,4161,20989,502397,1080,1,47,0,1,1039,0
Dialister_invisus_61905,700163419,ERR911957,3372,1217179,187505,796828,1478,755,32176,130227,1460,687,155329,666601,18,68,90785,1904590,4428,15079,374783,819,0,68,0,2,684,1
Dialister_invisus_61905,700163419,ERR911976,4606,1221173,188157,799464,1996,1044,39097,160552,1975,976,149060,638912,21,68,86872,1825565,4299,19230,461439,987,0,67,1,3,973,0
Dialister_invisus_61905,700163419,ERR911987,4756,1219143,187835,798121,1960,1154,42277,176863,1948,1089,145558,621258,12,65,83444,1776220,4110,22506,506943,1140,0,64,1,0,1088,1
Dialister_invisus_61905,700163419,ERR912028,4056,1219380,187805,798280,1753,948,37078,152622,1731,862,150727,645658,22,86,87309,1845396,4269,18756,438117,993,1,85,0,1,861,0
Dialister_invisus_61905,700163419,ERR912029,5049,1215575,187281,795791,2156,1180,45059,186507,2142,1118,142222,609284,14,62,82828,1741004,4020,22865,535489,1167,1,61,0,4,1110,4
Dialister_invisus_61905,700163419,ERR912085,4271,1218814,187785,797895,1761,1062,38409,159037,1729,980,149376,638858,32,82,86703,1825713,4158,19226,456772,1113,1,81,0,3,977,0
Dialister_invisus_61905,700163419,ERR912115,4646,1222837,188433,800596,1967,1129,41458,172087,1932,1054,146975,628509,35,75,84640,1796831,4056,21504,493551,1206,1,74,0,2,1052,0
Dialister_invisus_61905,700163419,ERR912121,3885,1217293,187482,796903,1666,898,31676,131072,1648,806,155806,665831,18,92,89839,1903259,4395,16033,376361,822,2,90,0,2,803,1
Dialister_invisus_61905,700163419,ERR912133,4224,1220401,188044,798946,1805,999,38628,160578,1786,945,149416,638368,19,54,86219,1824646,4239,19832,460882,1020,0,54,0,2,941,2
Dialister_invisus_61905,700163419,ERR912152,3633,1214149,186993,794783,1595,788,31135,127772,1583,737,155858,667011,12,51,90473,1906162,4398,15100,367385,831,1,50,0,2,734,1
Dialister_invisus_61905,700164735,700172279,5030,1220507,188092,799021,2128,1240,43902,182348,2116,1162,144190,616673,12,78,83664,1762263,4092,22397,523480,1167,2,76,0,2,1160,0
Dialister_invisus_61905,700164735,ERR911953,5566,1216719,187513,796521,2395,1308,48006,199728,2379,1261,139507,596793,16,47,81151,1705259,3969,24543,573357,1284,0,46,1,5,1256,0
Dialister_invisus_61905,700164735,ERR911957,5025,1216447,187426,796361,2191,1159,43680,179043,2171,1073,143746,617318,20,86,84300,1763502,4152,21490,514535,1104,0,85,1,3,1069,1
Dialister_invisus_61905,700164735,ERR911976,5749,1221528,188308,799721,2513,1332,49353,203620,2495,1265,138955,596101,18,67,81287,1702987,4029,24828,584793,1239,0,67,0,5,1260,0
Dialister_invisus_61905,700164735,ERR911987,5595,1219605,188028,798439,2391,1342,48803,203085,2382,1270,139225,595354,9,72,80564,1701556,3942,25389,582564,1302,0,72,0,2,1267,1
Dialister_invisus_61905,700164735,ERR912028,5500,1219440,187902,798322,2427,1280,49490,204730,2401,1168,138412,593592,26,112,80715,1696080,3981,25324,587588,1278,1,110,1,2,1166,0
Dialister_invisus_61905,700164735,ERR912029,5888,1216977,187588,796734,2496,1471,52114,217169,2477,1412,135474,579565,19,59,78910,1655951,3834,26917,623249,1341,1,58,0,6,1403,3
Dialister_invisus_61905,700164735,ERR912085,5921,1218950,187904,798004,2513,1415,51603,213908,2499,1353,136301,584096,14,62,79739,1668736,3813,26188,614084,1452,1,60,1,4,1349,0
Dialister_invisus_61905,700164735,ERR912121,5294,1218309,187703,797589,2273,1278,45500,188584,2257,1188,142203,609005,16,90,82565,1740415,4035,23365,541193,1194,2,87,1,4,1183,1
Dialister_invisus_61905,700164735,ERR912133,5408,1221322,188249,799577,2332,1309,48420,201097,2315,1243,139829,598480,17,66,81251,1710172,4017,24871,577175,1245,0,65,1,4,1237,2
Dialister_invisus_61905,700164735,ERR912152,5292,1214757,187192,795180,2304,1202,44426,183254,2293,1133,142766,611926,11,69,83485,1748246,4047,22140,526434,1188,1,67,1,4,1128,1
Dialister_invisus_61905,700172279,ERR911953,5153,1217689,187536,797103,2219,1174,47116,194862,2210,1102,140420,602241,9,72,82415,1720231,4077,23448,559914,1224,3,69,0,2,1099,1
Dialister_invisus_61905,700172279,ERR911957,3764,1217072,187477,796720,1653,873,35871,147323,1629,795,151606,649397,24,78,88405,1855424,4362,17513,423544,912,1,77,0,2,791,2
Dialister_invisus_61905,700172279,ERR911976,4870,1222171,188308,800085,2098,1131,43917,181605,2084,1056,144391,618480,14,75,84192,1767045,4203,22058,521656,1101,1,74,0,3,1053,0
Dialister_invisus_61905,700172279,ERR911987,5295,1220247,188028,798812,2234,1317,47909,201230,2223,1248,140119,597582,11,69,80325,1708467,3954,25742,576640,1308,1,68,0,1,1246,1
Dialister_invisus_61905,700172279,ERR912028,4764,1218804,187727,797857,2060,1159,44697,185569,2036,1062,143030,612288,24,97,83095,1749659,4110,22996,532541,1170,2,95,0,1,1060,1
Dialister_invisus_61905,700172279,ERR912029,5153,1215821,187292,795936,2247,1207,47272,196379,2233,1146,140020,599557,14,61,81651,1712994,4026,24117,563832,1188,3,58,0,4,1139,3
Dialister_invisus_61905,700172279,ERR912085,5200,1219561,187889,798370,2164,1298,48195,200699,2147,1223,139694,597671,17,75,81558,1707570,3885,24489,576210,1398,1,74,0,3,1219,1
Dialister_invisus_61905,700172279,ERR912115,5621,1222438,188379,800263,2370,1396,51735,214678,2345,1309,136644,585585,25,87,79542,1673331,3882,26670,615954,1410,1,86,0,3,1305,1
Dialister_invisus_61905,700172279,ERR912121,4409,1218268,187598,797523,1898,1043,39126,162744,1883,953,148472,634779,15,90,86026,1814075,4236,19990,467219,1023,3,87,0,3,948,2
Dialister_invisus_61905,700172279,ERR912133,5233,1220431,188023,798950,2240,1262,48428,202333,2222,1189,139595,596617,18,73,80903,1704943,4005,25191,580515,1293,2,71,0,2,1184,3
Dialister_invisus_61905,700172279,ERR912152,4431,1213890,186943,794580,1942,990,38323,158746,1936,924,148620,635834,6,66,86662,1816595,4245,18942,456273,1023,2,64,0,2,920,2
Dialister_invisus_61905,ERR911953,ERR911957,4626,1215459,187176,795642,2036,993,42863,175861,2019,923,144313,619781,17,70,84967,1770203,4173,20776,505697,1110,1,69,0,4,918,1
Dialister_invisus_61905,ERR911953,ERR911976,5257,1221705,188246,799748,2313,1169,47043,194670,2296,1113,141203,605078,17,56,82470,1728684,4080,23663,559108,1239,1,54,1,5,1108,0
Dialister_invisus_61905,ERR911953,ERR911987,5880,1218617,187797,797714,2484,1384,55455,231499,2476,1314,132342,566215,8,70,76679,1618186,3780,29256,663723,1518,0,69,1,3,1310,1
Dialister_invisus_61905,ERR911953,ERR912028,4697,1218390,187638,797570,2070,1065,43625,180573,2044,989,144013,616997,26,76,83943,1762911,4137,22091,518467,1161,1,75,0,3,986,0
Dialister_invisus_61905,ERR911953,ERR912029,5436,1216123,187396,796115,2348,1251,49986,208309,2327,1190,137410,587806,21,61,80150,1679374,3894,25597,598025,1305,1,60,0,7,1179,4
Dialister_invisus_61905,ERR911953,ERR912085,5024,1218625,187763,797691,2124,1195,45706,190430,2105,1126,142057,607261,19,69,82518,1735305,3960,23418,546534,1338,2,67,0,4,1122,0
Dialister_invisus_61905,ERR911953,ERR912121,5344,1216136,187287,796131,2345,1201,46450,192864,2332,1142,140837,603267,13,59,82207,1723595,3999,23597,553738,1257,2,57,0,4,1137,1
Dialister_invisus_61905,ERR911953,ERR912133,5355,1220296,188014,798826,2347,1233,49926,209293,2332,1169,138088,589533,15,64,79962,1684710,3927,26082,600420,1377,1,63,0,4,1163,2
Dialister_invisus_61905,ERR911953,ERR912152,4464,1213586,186893,794337,1986,939,37996,157163,1970,868,148897,637174,16,71,86792,1820503,4227,18752,451693,1044,2,69,0,2,865,1
Dialister_invisus_61905,ERR911957,ERR911976,4075,1220665,188064,799090,1812,902,40022,163524,1791,812,148042,635566,21,90,86739,1815678,4281,19435,470102,1035,0,89,1,4,807,1
Dialister_invisus_61905,ERR911957,ERR911987,4699,1218276,187698,797521,2016,1124,46471,192613,2002,1048,141227,604908,14,76,81868,1728842,4014,24107,552481,1251,0,75,1,2,1044,2
Dialister_invisus_61905,ERR911957,ERR912028,3977,1219364,187819,798228,1799,899,42207,173398,1774,797,145612,624830,25,102,84905,1785376,4209,21236,497863,1095,0,102,0,3,793,1
Dialister_invisus_61905,ERR911957,ERR912029,4624,1216955,187494,796686,2010,1058,44634,183645,1991,986,142860,613041,19,72,83620,1751429,4074,22246,527537,1152,1,71,0,6,975,5
Dialister_invisus_61905,ERR911957,ERR912085,4056,1218509,187720,797659,1748,952,41273,170154,1725,872,146447,627505,23,80,85677,1792743,4095,20352,488910,1200,1,79,0,4,867,1
Dialister_invisus_61905,ERR911957,ERR912115,5214,1220352,188043,798891,2305,1201,50261,206442,2270,1103,137782,592449,35,98,81124,1692341,3882,24969,592959,1398,1,97,0,4,1098,1
Dialister_invisus_61905,ERR911957,ERR912121,3692,1217640,187540,797110,1650,819,33760,137540,1627,725,153780,659570,23,94,89545,1884761,4404,16419,395346,855,2,92,0,4,719,2
Dialister_invisus_61905,ERR911957,ERR912133,4277,1219734,187889,798464,1905,956,42297,174954,1879,885,145592,623510,26,71,84753,1781625,4152,21340,502373,1149,0,71,0,4,878,3
Dialister_invisus_61905,ERR911957,ERR912152,3457,1213340,186812,794211,1577,692,32485,131907,1556,618,154327,662304,21,74,90493,1892051,4368,15119,379705,897,0,74,0,5,611,2
Dialister_invisus_61905,ERR911964,ERR911969,4479,1217082,187521,796787,1991,1056,47139,197122,1965,949,140382,599665,26,107,81161,1713820,4014,24725,565399,1242,1,106,0,3,946,0
Dialister_invisus_61905,ERR911969,ERR912048,3916,1221009,188158,799374,1705,969,37792,156488,1661,846,150366,642886,44,123,86912,1837423,4323,19254,449253,957,4,119,0,3,843,0
Dialister_invisus_61905,ERR911969,ERR912071,3684,1221482,188321,799738,1643,845,41988,175717,1611,758,146333,624021,32,87,83957,1783885,4221,22156,503957,1038,2,85,0,2,755,1
Dialister_invisus_61905,ERR911969,ERR912127,4411,1220444,188118,798980,1985,1027,43379,179547,1963,918,144739,619433,22,109,84345,1769847,4107,21768,515730,1143,0,109,0,5,913,0
Dialister_invisus_61905,ERR911972,ERR911992,4646,1208822,186110,791404,2022,1096,45292,188382,1994,1013,140818,603022,28,83,81450,1723620,3996,23703,540168,1275,0,83,0,2,1009,2
Dialister_invisus_61905,ERR911976,ERR911987,5655,1222541,188431,800293,2421,1370,51902,216318,2410,1299,136529,583975,11,71,78852,1669149,3924,27396,620175,1383,0,71,0,3,1295,1
Dialister_invisus_61905,ERR911976,ERR912028,4858,1223163,188418,800736,2163,1106,46321,191487,2140,1006,142097,609249,23,100,82879,1740719,4149,23549,549727,1185,0,99,1,4,1002,0
Dialister_invisus_61905,ERR911976,ERR912029,5224,1221119,188216,799422,2288,1230,48115,200185,2272,1162,140101,599237,16,68,81493,1712231,3987,24665,574630,1260,1,67,0,8,1151,3
Dialister_invisus_61905,ERR911976,ERR912040,6762,1216106,187396,796172,2902,1592,60849,251898,2882,1511,126547,544274,20,81,74944,1554251,3627,30739,723302,1653,1,79,1,4,1507,0
Dialister_invisus_61905,ERR911976,ERR912085,4908,1223753,188616,801108,2078,1196,44125,182210,2054,1100,144491,618898,24,96,84209,1768432,4053,22171,523187,1272,1,94,1,6,1094,0
Dialister_invisus_61905,ERR911976,ERR912115,5433,1226646,189097,803034,2356,1267,50905,211390,2327,1184,138192,591644,29,83,80462,1690540,3930,26071,606722,1377,1,81,1,5,1179,0
Dialister_invisus_61905,ERR911976,ERR912121,4555,1222176,188318,800088,2001,1040,40742,167778,1987,958,147576,632310,14,82,85723,1806968,4239,20580,481704,1050,2,79,1,4,953,1
Dialister_invisus_61905,ERR911976,ERR912133,4792,1225112,188842,802016,2114,1112,45449,189277,2093,1050,143393,612739,21,62,82898,1751200,4119,23549,543070,1212,0,61,1,5,1043,2
Dialister_invisus_61905,ERR911976,ERR912152,4605,1217936,187607,797238,2038,995,39899,164214,2020,913,147708,633024,18,82,86372,1808500,4200,19529,472027,1086,0,82,0,6,905,2
Dialister_invisus_61905,ERR911987,ERR912028,5400,1220239,187995,798820,2326,1305,52514,219404,2306,1196,135481,579416,20,109,78042,1656360,3846,28147,628622,1443,1,107,1,0,1195,1
Dialister_invisus_61905,ERR911987,ERR912029,6054,1217141,187582,796816,2595,1468,56884,238343,2582,1408,130698,558473,13,60,75455,1596277,3687,30428,683095,1506,1,59,0,4,1400,4
Dialister_invisus_61905,ERR911987,ERR912085,5258,1221610,188317,799707,2207,1301,52879,220912,2191,1218,135438,578795,16,83,78187,1654475,3723,27995,633181,1560,0,82,1,2,1215,1
Dialister_invisus_61905,ERR911987,ERR912115,5514,1224149,188753,801388,2378,1320,52199,217591,2355,1250,136554,583797,23,70,78848,1668718,3825,27465,623850,1458,0,69,1,2,1247,1
Dialister_invisus_61905,ERR911987,ERR912121,5520,1218382,187705,797604,2345,1344,49303,206901,2332,1240,138402,590703,13,104,79407,1688814,3888,26587,592766,1350,2,101,1,2,1236,2
Dialister_invisus_61905,ERR911987,ERR912133,5680,1221714,188311,799775,2425,1366,52928,222282,2412,1294,135383,577493,13,72,77732,1650913,3834,28467,636930,1449,0,71,1,2,1289,3
Dialister_invisus_61905,ERR911987,ERR912152,5227,1215417,187248,795571,2293,1182,48422,201600,2283,1107,138826,593971,10,75,80480,1697515,3918,25252,578216,1332,0,74,1,2,1103,2
Dialister_invisus_61905,ERR911992,ERR912099,3840,1216949,187438,796764,1657,840,35980,148030,1633,771,151458,648734,24,69,87884,1853950,4368,18022,425144,924,1,68,0,2,769,0
Dialister_invisus_61905,ERR912028,ERR912029,4987,1219112,187824,798113,2198,1202,48614,202155,2171,1115,139210,595958,27,87,80770,1703156,3948,25345,579833,1287,0,87,0,6,1105,4
Dialister_invisus_61905,ERR912028,ERR912085,4549,1222278,188330,800133,1924,1127,46416,193156,1895,1029,141914,606977,29,98,82445,1734577,3909,23925,554133,1410,1,97,0,3,1026,0
Dialister_invisus_61905,ERR912028,ERR912121,4864,1219842,187883,798564,2133,1154,44696,185008,2106,1033,143187,613556,27,121,83195,1753408,4065,22973,530851,1200,2,119,0,4,1028,1
Dialister_invisus_61905,ERR912028,ERR912133,4386,1223019,188417,800643,1907,1063,44871,187893,1881,971,143546,612750,26,92,82506,1751640,4104,23921,538543,1215,1,91,0,3,966,2
Dialister_invisus_61905,ERR912028,ERR912152,4260,1214944,187050,795272,1910,939,39981,164574,1888,852,147069,630698,22,87,85928,1801966,4200,19877,472783,1062,1,86,0,3,848,1
Dialister_invisus_61905,ERR912029,ERR912085,5790,1217627,187669,797099,2452,1422,53999,225025,2433,1349,133670,572074,19,73,78129,1634424,3669,27805,645707,1563,1,72,0,7,1338,4
Dialister_invisus_61905,ERR912029,ERR912121,5026,1219823,187985,798560,2192,1196,45324,188407,2175,1118,142661,610153,17,78,82669,1743752,4038,23415,540636,1170,3,75,0,6,1107,5
Dialister_invisus_61905,ERR912029,ERR912133,5399,1219599,187926,798432,2359,1298,52554,219894,2339,1237,135372,578538,20,61,78392,1653430,3792,27704,630541,1437,1,60,0,7,1226,4
Dialister_invisus_61905,ERR912029,ERR912152,4153,1213568,186907,794368,1802,942,40162,166993,1786,875,146745,627375,16,67,85201,1792787,4137,20410,479504,1065,2,65,0,6,866,3
Dialister_invisus_61905,ERR912034,ERR912186,5459,1227260,189185,803427,2452,1184,46992,193416,2417,1079,142193,610011,35,105,82842,1743231,3960,23725,555233,1290,0,105,0,4,1074,1
Dialister_invisus_61905,ERR912048,ERR912127,3604,1222505,188478,800315,1551,857,35537,146423,1513,744,152941,653892,38,113,88799,1868590,4287,17467,420776,1026,3,110,0,2,742,0
Dialister_invisus_61905,ERR912085,ERR912115,5520,1225795,188966,802480,2361,1327,53255,220093,2331,1251,135711,582387,30,76,79381,1664012,3768,27093,631641,1545,0,76,0,5,1246,0
Dialister_invisus_61905,ERR912085,ERR912121,5137,1219094,187791,798055,2173,1249,46022,191259,2158,1170,141769,606796,15,79,82516,1733996,3876,23568,548829,1380,3,76,0,5,1164,1
Dialister_invisus_61905,ERR912085,ERR912133,4712,1223079,188505,800662,2018,1142,47914,200360,2003,1078,140591,600302,15,64,81452,1715542,3912,24891,574779,1410,1,63,0,5,1071,2
Dialister_invisus_61905,ERR912085,ERR912152,4444,1216171,187342,796055,1905,1036,39659,164071,1888,974,147683,631984,17,62,85964,1805920,4068,19823,471178,1212,2,60,0,4,969,1
Dialister_invisus_61905,ERR912115,ERR912121,5545,1221753,188250,799842,2406,1321,50789,210502,2378,1212,137461,589340,28,109,79892,1684321,3807,26317,603734,1455,3,106,0,2,1209,1
Dialister_invisus_61905,ERR912115,ERR912133,5211,1225917,188937,802568,2264,1251,48797,202891,2227,1176,140140,599677,37,75,81197,1713871,3963,25279,582041,1353,1,74,0,4,1170,2
Dialister_invisus_61905,ERR912115,ERR912152,4870,1218595,187771,797667,2147,1106,44958,185697,2113,1014,142813,611970,34,92,83081,1748815,4014,22826,533002,1263,2,90,0,4,1009,1
Dialister_invisus_61905,ERR912121,ERR912133,4767,1219877,187912,798571,2047,1145,43876,183098,2027,1074,144036,615473,20,71,83027,1759330,4062,23088,524991,1215,1,70,0,5,1066,3
Dialister_invisus_61905,ERR912121,ERR912152,3937,1213739,186871,794489,1754,849,33923,139637,1741,767,152948,654852,13,82,88917,1871352,4287,16733,401215,963,3,79,0,4,761,2
Dialister_invisus_61905,ERR912133,ERR912152,4227,1218211,187646,797404,1854,952,40720,169715,1839,894,146926,627689,15,58,85036,1793906,4125,20871,487116,1158,1,57,0,4,889,1
