species_name,sample 1,sample 2,core_diff,core_len,core_len_4D,core_len_1D,core_diff_4D,core_diff_1D,recomb_len_4D,recomb_len_1D,recomb_diff_4D,recomb_diff_1D,clonal_len_4D,clonal_len_1D,clonal_diff_4D,clonal_diff_1D,clonal_n,clonal_m,clonal_nn,recomb_n,recomb_m,recomb_nn,clonal_mut_n,clonal_mut_m,clonal_mut_nn,recomb_mut_n,recomb_mut_m,recomb_mut_nn
Parabacteroides_distasonis_56985,700013603,700034794,2729,2519732,354206,1633822,1105,475,28188,129515,1076,397,326018,1504307,29,78,228532,4276418,7971,19750,368150,645,3,75,0,1,396,0
Parabacteroides_distasonis_56985,700013603,700037649,2750,2531861,356248,1641787,1139,511,33028,151121,1106,437,323220,1490666,33,74,226338,4237797,7863,22892,429700,771,2,72,0,1,436,0
Parabacteroides_distasonis_56985,700013603,700037738,2698,2504758,351537,1623936,1097,461,27575,126745,1065,375,323962,1497191,32,86,227859,4255764,7950,19372,360239,624,4,82,0,0,375,0
Parabacteroides_distasonis_56985,700013603,700100600,2587,2508800,352300,1626734,1053,447,26502,121557,1020,371,325798,1505177,33,76,228961,4278608,7962,18492,345597,582,3,73,0,2,369,0
Parabacteroides_distasonis_56985,700013603,700107059,2576,2518375,353956,1632976,1059,449,26558,121727,1026,374,327398,1511249,33,75,229650,4296087,8010,18506,346099,576,2,73,0,1,373,0
Parabacteroides_distasonis_56985,700013603,700116076,3168,2527537,355661,1638961,1308,565,33771,154365,1281,487,321890,1484596,27,78,225497,4220473,7818,23312,439003,780,3,75,0,3,483,1
Parabacteroides_distasonis_56985,700013603,ERR911965,2688,2532425,356349,1642151,1110,495,33045,151214,1078,430,323304,1490937,32,65,226346,4238596,7869,22952,429919,771,2,63,0,1,429,0
Parabacteroides_distasonis_56985,700013603,ERR912037,884,2535615,356810,1644231,365,201,9884,43276,343,145,346926,1600955,22,56,243354,4551039,8472,6214,123431,183,3,53,0,0,145,0
Parabacteroides_distasonis_56985,700013603,ERR912061,2098,2534274,356645,1643365,836,421,24975,112585,804,340,331670,1530780,32,81,232572,4351686,8082,16886,320308,561,3,78,0,1,339,0
Parabacteroides_distasonis_56985,700013603,ERR912065,2123,2534419,356661,1643444,841,429,24855,112138,807,342,331806,1531306,34,87,232691,4353154,8073,16813,319028,573,2,85,0,1,341,0
Parabacteroides_distasonis_56985,700013603,ERR912110,5554,2531488,356191,1641578,2285,1070,65377,296912,2219,925,290814,1344666,66,145,204777,3822108,7113,44418,844812,1506,2,143,0,7,918,0
Parabacteroides_distasonis_56985,700014837,700015181,1518,2516599,353683,1631840,666,255,16616,75872,647,198,337067,1555968,19,57,236398,4423214,8292,11552,215692,372,3,54,0,1,197,0
Parabacteroides_distasonis_56985,700014837,700021902,1528,2534584,356238,1643468,662,267,16297,74400,641,197,339941,1569068,21,70,238347,4460436,8421,11351,211477,372,1,69,0,2,195,0
Parabacteroides_distasonis_56985,700014837,700024024,1351,2523457,354335,1636184,535,291,16721,77751,521,230,337614,1558433,14,61,236856,4430082,8361,12003,220899,351,2,59,0,1,228,1
Parabacteroides_distasonis_56985,700014837,700037123,1539,2533810,356147,1642961,669,258,16624,76011,651,198,339523,1566950,18,60,238043,4454404,8403,11573,216085,375,1,59,0,1,197,0
Parabacteroides_distasonis_56985,700014837,700038386,392,2464130,343720,1597504,146,72,4453,20808,134,33,339267,1576696,12,39,241353,4480308,8427,3200,59101,123,2,37,0,0,33,0
Parabacteroides_distasonis_56985,700014837,700119562,1564,2515608,353600,1631201,681,267,16423,74924,655,199,337177,1556277,26,68,236452,4424063,8316,11433,212976,363,3,65,0,1,198,0
Parabacteroides_distasonis_56985,700014837,ERR911993,1869,2535223,356307,1643901,803,341,19883,89660,783,267,336424,1554241,20,74,236272,4418129,8322,13511,255028,441,1,73,0,2,265,0
Parabacteroides_distasonis_56985,700014837,donald4-11-7-0_,2421,2524573,354624,1636865,1041,433,32463,148399,1014,343,322161,1488466,27,90,226605,4230774,8019,22281,422157,759,1,89,0,2,341,0
Parabacteroides_distasonis_56985,700015181,700024024,2419,2512364,353023,1629125,1019,437,30183,139810,994,355,322840,1489315,25,82,226102,4233884,7959,21501,397266,663,5,77,0,0,354,1
Parabacteroides_distasonis_56985,700015181,700038386,1793,2445203,341231,1585305,772,296,20632,94883,752,228,320599,1490422,20,68,228119,4235188,7959,14520,269667,462,5,63,0,1,227,0
Parabacteroides_distasonis_56985,700015181,700119562,86,2521716,354805,1635262,22,54,146,565,1,1,354659,1634697,21,53,248127,4647339,8625,84,1611,0,2,51,0,0,1,0
Parabacteroides_distasonis_56985,700015181,ERR911993,436,2526266,355418,1638241,157,146,3831,16365,131,76,351587,1621876,26,70,246284,4610737,8607,2385,46647,63,4,66,0,1,75,0
Parabacteroides_distasonis_56985,700015181,donald4-11-7-0_,1138,2513637,353374,1629927,465,271,17656,80354,437,177,335718,1549573,28,94,235819,4404662,8238,11805,228828,429,3,91,0,2,175,0
Parabacteroides_distasonis_56985,700015702,700164792,411,2541725,357709,1648179,151,109,4888,21989,134,62,352821,1626190,17,47,246919,4623086,8565,3201,62637,129,1,46,0,1,61,0
Parabacteroides_distasonis_56985,700015702,ERR912061,7347,2533165,356557,1642646,3114,1312,92809,423715,3068,1147,263748,1218931,46,165,185883,3464373,6537,63431,1205635,2079,1,163,1,4,1142,1
Parabacteroides_distasonis_56985,700015702,ERR912065,7422,2533622,356631,1642920,3137,1334,87485,398717,3084,1164,269146,1244203,53,170,189676,3536225,6708,59676,1134561,1914,1,168,1,4,1159,1
Parabacteroides_distasonis_56985,700015702,ERR912110,6667,2539691,357405,1646853,2848,1208,80138,365024,2792,1052,277267,1281829,56,156,195352,3643241,6894,54603,1038702,1767,3,152,1,5,1046,1
Parabacteroides_distasonis_56985,700016000,700117031,3975,2548434,358507,1652571,1611,790,57943,266641,1547,650,300564,1385930,64,140,210380,3939961,7449,40359,758307,1257,2,138,0,1,648,1
Parabacteroides_distasonis_56985,700016000,700172132,223,2548520,358363,1652601,68,81,1542,6769,45,35,356821,1645832,23,46,249873,4678926,8697,1009,19280,18,0,46,0,0,35,0
Parabacteroides_distasonis_56985,700016000,ERR911954,2245,2551176,358877,1654351,950,443,30350,138952,899,352,328527,1515399,51,91,230349,4307724,8124,20691,395529,636,0,91,0,0,351,1
Parabacteroides_distasonis_56985,700016000,SRR341698,218,2533924,355907,1643054,66,81,1403,6145,43,32,354504,1636909,23,49,248772,4653207,8748,910,17507,18,0,49,0,0,32,0
Parabacteroides_distasonis_56985,700016716,700024930,6193,2517073,353802,1632132,2545,1143,88091,402108,2497,1001,265711,1230024,48,142,187372,3496190,6510,60634,1143650,2040,0,141,1,5,996,0
Parabacteroides_distasonis_56985,700021824,700037357,39,2535164,356240,1643833,7,24,107,396,4,1,356133,1643437,3,23,249838,4671746,8727,65,1123,0,0,23,0,0,1,0
Parabacteroides_distasonis_56985,700021824,700038072,38,2534792,356089,1643566,6,25,166,643,4,2,355923,1642923,2,23,249824,4670203,8742,103,1826,0,0,23,0,0,2,0
Parabacteroides_distasonis_56985,700021824,700100227,1140,2532589,355778,1642188,468,240,12183,55255,414,140,343595,1586933,54,100,241213,4511183,8403,8534,156961,270,4,96,0,0,140,0
Parabacteroides_distasonis_56985,700021824,700107930,1761,2533228,355976,1642602,719,384,27933,128313,691,278,328043,1514289,28,106,230193,4304694,7980,19492,364751,696,4,102,0,1,277,0
Parabacteroides_distasonis_56985,700021876,700024086,102,2520612,354160,1634300,13,65,157,624,2,2,354003,1633676,11,63,248420,4643932,8676,102,1770,0,1,62,0,0,2,0
Parabacteroides_distasonis_56985,700021876,700095213,274,2516033,353552,1631354,93,80,1947,9048,72,17,351605,1622306,21,63,246659,4611679,8580,1332,25770,42,1,62,0,0,17,0
Parabacteroides_distasonis_56985,700021876,700096047,573,2521412,354369,1634819,217,138,4961,22830,193,71,349408,1611989,24,67,245130,4582287,8550,3403,64961,126,2,65,0,0,71,0
Parabacteroides_distasonis_56985,700021876,ERR911959,99,2516306,353623,1631513,19,55,118,457,4,1,353505,1631056,15,54,248011,4636502,8655,76,1295,0,0,54,0,0,1,0
Parabacteroides_distasonis_56985,700021876,ERR912059,107,2521934,354410,1635166,24,61,118,448,4,2,354292,1634718,20,59,248557,4646930,8667,75,1269,0,0,59,0,0,2,0
Parabacteroides_distasonis_56985,700021876,SRR341697,121,2509736,352421,1627180,27,66,147,587,3,0,352274,1626593,24,66,247504,4623605,8670,97,1664,0,0,66,0,0,0,0
Parabacteroides_distasonis_56985,700021902,700024024,2514,2528532,355353,1639599,1051,464,30728,142236,1028,367,324625,1497363,23,97,227292,4256733,8064,21872,404161,675,3,94,0,1,365,1
Parabacteroides_distasonis_56985,700021902,700038386,1797,2462248,343598,1596335,767,302,20571,94621,749,227,323027,1501714,18,75,229820,4267237,8085,14488,268916,459,3,72,0,2,225,0
Parabacteroides_distasonis_56985,700021902,700119562,117,2526125,355473,1638137,27,74,87,328,1,1,355386,1637809,26,73,248605,4656116,8706,51,933,0,5,68,0,0,1,0
Parabacteroides_distasonis_56985,700021902,ERR911993,443,2544559,358036,1650091,155,156,3888,16598,131,76,354148,1633493,24,80,248034,4643712,8733,2415,47319,60,3,77,0,1,75,0
Parabacteroides_distasonis_56985,700021902,donald4-11-7-0_,1159,2531917,355989,1641756,468,287,17685,80464,439,178,338304,1561292,29,109,237564,4437942,8370,11811,229149,432,3,106,0,1,177,0
Parabacteroides_distasonis_56985,700023113,700024545,79,2528623,355185,1639598,21,37,90,357,5,1,355095,1639241,16,36,249174,4659789,8760,63,1008,0,0,36,0,0,1,0
Parabacteroides_distasonis_56985,700023113,700037868,62,2536764,356665,1644926,14,33,109,424,3,0,356556,1644502,11,33,249790,4674938,8778,78,1194,0,0,33,0,0,0,0
Parabacteroides_distasonis_56985,700023113,700098867,2956,2532569,356189,1642201,1181,621,42749,194652,1125,480,313440,1447549,56,141,220208,4114735,7704,29195,553744,1017,1,140,0,4,475,1
Parabacteroides_distasonis_56985,700023113,700106465,54,2535176,356344,1643869,16,27,138,543,6,1,356206,1643326,10,26,249687,4671504,8787,93,1536,0,0,26,0,0,1,0
Parabacteroides_distasonis_56985,700023113,700106836,2849,2530238,355763,1640736,1149,592,38796,175738,1089,454,316967,1464998,60,138,223002,4164186,7806,26233,500060,921,1,137,0,2,451,1
Parabacteroides_distasonis_56985,700023113,700172813,3084,2535253,356580,1643932,1259,623,44219,200587,1202,490,312361,1443345,57,133,219749,4102549,7737,29917,570842,1002,1,132,0,3,486,1
Parabacteroides_distasonis_56985,700023845,700023919,1560,2526950,354239,1638256,633,293,18316,83439,611,225,335923,1554817,22,68,237335,4418629,8487,12313,237551,453,6,62,0,1,223,1
Parabacteroides_distasonis_56985,700023919,700037916,1593,2557467,359831,1658290,645,309,18601,84518,619,231,341230,1573772,26,78,239281,4473434,8601,12409,240686,459,5,73,0,1,229,1
Parabacteroides_distasonis_56985,700024024,700037123,2549,2528380,355354,1639503,1062,461,31132,143783,1041,377,324222,1495720,21,84,227039,4252057,8064,22075,408599,675,3,81,0,0,376,1
Parabacteroides_distasonis_56985,700024024,700038386,1588,2455836,342503,1592148,630,323,20639,96800,613,249,321864,1495348,17,74,228795,4249212,8037,14985,274953,462,4,70,0,1,247,1
Parabacteroides_distasonis_56985,700024024,700119562,2555,2512132,353029,1629021,1072,466,30925,142985,1046,372,322104,1486036,26,94,225628,4224518,7962,21980,406309,666,5,89,0,0,371,1
Parabacteroides_distasonis_56985,700024024,ERR911993,2872,2528471,355347,1639592,1195,538,34336,157152,1174,442,321011,1482440,21,96,225226,4214114,7980,23945,446776,735,3,93,0,1,440,1
Parabacteroides_distasonis_56985,700024024,donald4-11-7-0_,3392,2517001,353496,1632047,1440,619,44550,204797,1413,503,308946,1427250,27,116,217167,4056891,7692,31041,582324,1026,2,114,0,1,501,1
Parabacteroides_distasonis_56985,700024086,700037042,118,2534120,356361,1643225,20,75,97,355,2,0,356264,1642870,18,75,249457,4670435,8718,54,1011,0,7,68,0,0,0,0
Parabacteroides_distasonis_56985,700024086,700095213,283,2526187,355205,1638075,91,89,1917,8912,70,15,353288,1629163,21,74,247439,4631449,8601,1304,25387,45,2,72,0,0,15,0
Parabacteroides_distasonis_56985,700024086,700096047,581,2532168,356106,1641964,217,147,4961,22796,192,73,351145,1619168,25,74,245918,4602997,8589,3397,64868,123,3,71,0,0,73,0
Parabacteroides_distasonis_56985,700024086,ERR911959,104,2527187,355366,1638743,19,60,157,624,6,1,355209,1638119,13,59,248778,4656885,8694,102,1770,0,1,58,0,0,1,0
Parabacteroides_distasonis_56985,700024086,ERR912059,111,2532465,356111,1642157,24,67,167,658,6,0,355944,1641499,18,67,249287,4666498,8712,109,1865,0,1,66,0,0,0,0
Parabacteroides_distasonis_56985,700024086,SRR341697,131,2519424,354002,1633610,28,74,97,359,3,1,353905,1633251,25,73,248240,4642816,8697,58,1019,0,1,72,0,0,1,0
Parabacteroides_distasonis_56985,700024449,700038594,33,2478161,348323,1606979,10,13,48,167,5,0,348275,1606812,5,13,244150,4568060,8226,21,480,0,0,13,0,0,0,0
Parabacteroides_distasonis_56985,700024449,700116401,49,2481239,348850,1608980,14,22,166,643,7,0,348684,1608337,7,22,244314,4572447,8250,103,1826,0,0,21,1,0,0,0
Parabacteroides_distasonis_56985,700024545,700037868,69,2530369,355430,1640752,11,38,68,256,2,0,355362,1640496,9,38,249344,4663384,8760,44,724,0,0,38,0,0,0,0
Parabacteroides_distasonis_56985,700024545,700098867,2942,2525739,354855,1637745,1172,614,42149,192486,1115,468,312706,1445259,57,146,220028,4108060,7689,28891,547562,1005,1,145,0,4,463,1
Parabacteroides_distasonis_56985,700024545,700106465,57,2529647,355301,1640269,11,30,138,536,3,1,355163,1639733,8,29,249272,4661164,8763,91,1517,0,0,29,0,0,1,0
Parabacteroides_distasonis_56985,700024545,700106836,2825,2524062,354596,1636691,1136,585,39567,179590,1076,450,315029,1457101,60,135,221983,4141547,7773,26787,511041,942,1,134,0,2,447,1
Parabacteroides_distasonis_56985,700024545,700172813,3063,2528224,355220,1639340,1250,613,44257,201072,1192,478,310963,1438268,58,135,219114,4087977,7713,30042,572172,1002,1,134,0,3,474,1
Parabacteroides_distasonis_56985,700024615,ERR912136,1653,2538518,356723,1645969,675,331,16920,78434,646,226,339803,1567535,29,105,238193,4456054,8358,11917,222980,405,5,100,0,1,225,0
Parabacteroides_distasonis_56985,700024752,700102356,189,2542980,357423,1648866,63,55,1546,7296,38,5,355877,1641570,25,50,249368,4666585,8757,1174,20672,42,0,50,0,0,5,0
Parabacteroides_distasonis_56985,700024752,700105940,199,2546775,358008,1651380,66,53,1556,7314,41,5,356452,1644066,25,48,249679,4673756,8763,1176,20727,39,0,48,0,0,5,0
Parabacteroides_distasonis_56985,700024752,700107189,184,2447757,340728,1586815,60,53,1506,7152,37,5,339222,1579663,23,48,241819,4488878,8292,1157,20263,36,0,48,0,0,5,0
Parabacteroides_distasonis_56985,700024752,700171115,848,2544093,357589,1649621,304,231,12863,58456,285,176,344726,1591165,19,55,241836,4523136,8523,8787,166296,285,0,55,0,0,176,0
Parabacteroides_distasonis_56985,700024752,ERR912173,214,2547279,358088,1651700,67,68,1546,7279,41,5,356542,1644421,26,63,249723,4674771,8769,1169,20629,39,1,62,0,0,5,0
Parabacteroides_distasonis_56985,700033153,SRR413620,6860,2506852,352246,1625637,2917,1258,88730,406263,2883,1131,263516,1219374,34,127,185323,3466196,6603,61670,1155208,1911,0,127,0,1,1127,3
Parabacteroides_distasonis_56985,700034794,700037649,2753,2526748,355143,1638342,1138,471,32824,153320,1121,420,322319,1485022,17,51,225171,4221948,7947,23809,435395,756,1,50,0,0,420,0
Parabacteroides_distasonis_56985,700034794,700037738,42,2508818,351905,1626503,10,22,167,640,6,1,351738,1625863,4,21,247604,4621282,8703,103,1817,0,1,20,0,0,1,0
Parabacteroides_distasonis_56985,700034794,700100600,234,2511544,352499,1628435,85,57,2080,9771,78,25,350419,1618664,7,32,246213,4601154,8625,1583,27673,57,1,31,0,0,25,0
Parabacteroides_distasonis_56985,700034794,700107059,233,2521320,354117,1634810,83,56,2088,9873,76,26,352029,1624937,7,30,246969,4619208,8634,1602,27954,63,1,29,0,0,26,0
Parabacteroides_distasonis_56985,700034794,700116076,792,2526921,355185,1638420,318,165,9499,43884,315,123,345686,1594536,3,42,242284,4532870,8454,6693,124686,273,3,39,0,0,123,0
Parabacteroides_distasonis_56985,700034794,ERR911965,2711,2527325,355208,1638730,1119,466,32343,150931,1096,414,322865,1487799,23,52,225529,4229891,7977,23487,428562,744,1,51,0,0,414,0
Parabacteroides_distasonis_56985,700034794,ERR912037,2315,2528953,355470,1639784,923,423,22712,105225,896,356,332758,1534559,27,67,232948,4362491,8238,16199,298987,489,2,65,0,1,355,0
Parabacteroides_distasonis_56985,700034794,ERR912061,1688,2529495,355581,1640150,677,304,17604,81714,669,249,337977,1558436,8,55,236649,4430301,8358,12578,232189,375,1,54,0,0,249,0
Parabacteroides_distasonis_56985,700034794,ERR912065,1702,2529327,355533,1640006,678,309,17593,81763,670,246,337940,1558243,8,63,236619,4429749,8361,12593,232315,381,1,62,0,0,246,0
Parabacteroides_distasonis_56985,700034794,ERR912110,6528,2524204,354789,1636716,2693,1181,75353,346473,2653,1047,279436,1290243,40,134,196219,3667568,6942,52484,985180,1755,1,133,0,5,1042,0
Parabacteroides_distasonis_56985,700037042,700095213,289,2529361,355732,1640126,95,89,1780,8393,66,15,353952,1631733,29,74,247777,4638809,8613,1223,23911,45,7,67,0,0,15,0
Parabacteroides_distasonis_56985,700037042,700096047,589,2536012,356762,1644436,225,146,4941,22749,191,72,351821,1621687,34,74,246233,4610218,8610,3386,64738,123,8,66,0,0,72,0
Parabacteroides_distasonis_56985,700037042,ERR911959,122,2530824,356000,1641090,29,67,138,545,6,2,355862,1640545,23,65,249065,4663870,8700,93,1542,0,6,59,0,0,2,0
Parabacteroides_distasonis_56985,700037042,ERR912059,120,2535865,356717,1644359,32,65,148,578,6,1,356569,1643781,26,64,249555,4673070,8718,98,1636,0,6,58,0,0,1,0
Parabacteroides_distasonis_56985,700037042,SRR341697,138,2522425,354501,1635534,35,75,97,358,3,1,354404,1635176,32,74,248488,4648334,8706,54,1020,0,6,68,0,0,1,0
Parabacteroides_distasonis_56985,700037123,700038386,1810,2461572,343521,1595923,774,295,20580,94701,755,225,322941,1501222,19,70,229715,4265872,8079,14497,269150,456,3,67,0,1,224,0
Parabacteroides_distasonis_56985,700037123,700119562,111,2526747,355587,1638567,28,63,97,356,1,0,355490,1638211,27,63,248649,4657290,8694,53,1015,0,4,59,0,0,0,0
Parabacteroides_distasonis_56985,700037123,ERR911993,442,2544717,358082,1650200,156,150,3902,16630,133,76,354180,1633570,23,74,248018,4643968,8724,2417,47407,66,2,72,0,1,75,0
Parabacteroides_distasonis_56985,700037123,donald4-11-7-0_,1152,2531371,355905,1641433,468,277,18016,82051,441,176,337889,1559382,27,101,237207,4432587,8352,12113,233605,435,2,99,0,1,175,0
Parabacteroides_distasonis_56985,700037357,700038072,28,2540814,357172,1647597,7,14,81,331,6,2,357091,1647266,1,12,250223,4682809,8766,60,933,0,0,12,0,0,2,0
Parabacteroides_distasonis_56985,700037357,700100227,1123,2540125,357185,1647178,465,229,12243,55550,413,142,344942,1591628,52,87,241583,4524868,8433,8570,157807,273,4,83,0,0,142,0
Parabacteroides_distasonis_56985,700037357,700107930,1777,2541823,357534,1648287,733,377,28070,128828,698,279,329464,1519459,35,98,230610,4319757,8010,19576,366200,708,4,94,0,1,278,0
Parabacteroides_distasonis_56985,700037649,700037738,2725,2511455,352420,1628236,1135,462,32185,150155,1109,405,320235,1478081,26,57,224560,4201745,7938,23332,426413,720,2,55,0,0,405,0
Parabacteroides_distasonis_56985,700037649,700100600,2629,2515439,353202,1631023,1099,450,30415,141623,1069,390,322787,1489400,30,60,226153,4234085,7962,21944,402256,669,1,59,0,1,389,0
Parabacteroides_distasonis_56985,700037649,700107059,2601,2525233,354869,1637408,1094,446,30432,141827,1065,395,324437,1495581,29,51,226841,4251907,7995,22003,402821,657,0,51,0,0,395,0
Parabacteroides_distasonis_56985,700037649,700116076,3153,2534982,356665,1643778,1325,557,37266,173016,1302,502,319399,1470762,23,55,222937,4181534,7815,26582,491602,864,1,54,0,2,499,1
Parabacteroides_distasonis_56985,700037649,ERR911965,112,2541694,357632,1648146,49,28,803,3673,35,9,356829,1644473,14,19,249619,4675061,8739,546,10464,9,0,19,0,0,9,0
Parabacteroides_distasonis_56985,700037649,ERR912037,2304,2541385,357585,1647936,944,450,27873,128776,917,393,329712,1519160,27,57,230352,4319034,8094,19761,365928,639,1,56,0,1,392,0
Parabacteroides_distasonis_56985,700037649,ERR912061,2096,2541274,357617,1647878,865,404,27984,128660,840,350,329633,1519218,25,54,230375,4319218,8061,19751,365572,657,0,54,0,1,349,0
Parabacteroides_distasonis_56985,700037649,ERR912065,2111,2541541,357631,1648021,865,409,28292,130456,838,352,329339,1517565,27,57,230162,4314472,8061,19998,370704,666,0,57,0,0,352,0
Parabacteroides_distasonis_56985,700037649,ERR912110,6491,2537187,356946,1645246,2692,1207,80202,369376,2646,1086,276744,1275870,46,121,193679,3627094,6837,56057,1050196,1875,1,120,0,4,1082,0
Parabacteroides_distasonis_56985,700037738,700100600,223,2499920,350482,1620717,85,49,2085,9827,75,24,348397,1610890,10,25,245377,4578698,8595,1591,27833,57,0,25,0,0,24,0
Parabacteroides_distasonis_56985,700037738,700107059,222,2508069,351814,1626058,83,50,2095,9863,73,25,349719,1616195,10,25,246031,4593950,8604,1593,27933,63,0,25,0,0,25,0
Parabacteroides_distasonis_56985,700037738,700116076,791,2511663,352472,1628366,321,161,9605,44358,316,123,342867,1584008,5,38,241110,4502487,8427,6774,126036,264,2,36,0,0,123,0
Parabacteroides_distasonis_56985,700037738,ERR911965,2676,2512025,352493,1628600,1113,454,30983,144466,1081,395,321510,1484134,32,59,225432,4218990,7980,22499,410209,690,0,59,0,0,395,0
Parabacteroides_distasonis_56985,700037738,ERR912037,2289,2513733,352759,1629737,923,409,22333,103606,890,343,330426,1526131,33,66,232110,4338063,8220,15961,294389,468,1,65,0,1,342,0
Parabacteroides_distasonis_56985,700037738,ERR912061,1670,2514113,352841,1629976,674,297,17307,80527,662,238,335534,1549449,12,59,235706,4404316,8325,12412,228806,363,0,59,0,0,238,0
Parabacteroides_distasonis_56985,700037738,ERR912065,1682,2514054,352814,1629923,675,300,17335,80640,663,238,335479,1549283,12,62,235707,4403808,8334,12424,229136,360,0,62,0,0,238,0
Parabacteroides_distasonis_56985,700037738,ERR912110,6486,2509303,352110,1626880,2677,1165,74036,341112,2633,1023,278074,1285768,44,142,195874,3654491,6939,51786,969834,1716,0,142,0,5,1018,0
Parabacteroides_distasonis_56985,700037868,700098867,2976,2536186,356729,1644616,1189,622,42847,194111,1143,484,313882,1450505,46,138,220718,4123033,7764,29003,552373,957,1,137,0,4,479,1
Parabacteroides_distasonis_56985,700037868,700106465,44,2537757,356746,1645595,6,28,119,476,5,1,356627,1645119,1,27,249907,4676663,8787,83,1345,0,0,27,0,0,1,0
Parabacteroides_distasonis_56985,700037868,700106836,2854,2533179,356225,1642691,1147,594,41222,186706,1113,470,315003,1455985,34,124,221616,4138584,7755,27839,531310,969,0,124,0,3,466,1
Parabacteroides_distasonis_56985,700037868,700172813,3096,2538542,357079,1646111,1260,625,44864,204901,1216,490,312215,1441210,44,135,219252,4096704,7674,30692,582949,1062,1,134,0,3,486,1
Parabacteroides_distasonis_56985,700038072,700100227,1132,2537974,356694,1645753,469,233,12281,55612,417,145,344413,1590141,52,88,241505,4520488,8430,8582,157981,273,4,84,0,0,145,0
Parabacteroides_distasonis_56985,700038072,700107930,1760,2538882,356940,1646330,726,371,27806,127504,699,271,329134,1518826,27,100,230691,4317777,8010,19373,362428,711,4,96,0,1,270,0
Parabacteroides_distasonis_56985,700038386,700119562,1836,2443533,340996,1584224,786,307,20205,92990,759,228,320791,1491234,27,79,228240,4237488,7974,14268,264252,450,5,74,0,1,227,0
Parabacteroides_distasonis_56985,700038386,ERR911993,2109,2463313,343733,1597023,896,366,24089,109768,874,290,319644,1487255,22,76,227711,4226053,8001,16730,312052,522,3,73,0,2,288,0
Parabacteroides_distasonis_56985,700038386,donald4-11-7-0_,2628,2454971,342410,1591549,1120,452,34617,159783,1087,354,307793,1431766,33,98,219470,4068109,7719,24246,454287,816,3,95,0,2,352,0
Parabacteroides_distasonis_56985,700038594,700116401,53,2478890,348458,1607467,20,19,225,853,11,1,348233,1606614,9,18,244071,4567527,8244,136,2423,0,0,17,1,0,1,0
Parabacteroides_distasonis_56985,700038806,700100600,7893,2508993,352327,1626850,3332,1380,93003,427742,3280,1222,259324,1199108,52,158,182953,3407855,6516,64490,1216651,2085,2,155,1,5,1216,1
Parabacteroides_distasonis_56985,700038806,700164792,412,2543850,357863,1649551,154,106,4897,22023,136,63,352966,1627528,18,43,247187,4626745,8652,3212,62731,126,2,41,0,1,62,0
Parabacteroides_distasonis_56985,700038806,ERR912061,7355,2533598,356490,1642929,3118,1313,92012,420412,3071,1157,264478,1222517,47,156,186431,3474505,6615,62957,1196206,2073,2,153,1,4,1152,1
Parabacteroides_distasonis_56985,700038806,ERR912065,7430,2533964,356533,1643149,3140,1335,93036,424886,3094,1177,263497,1218263,46,158,185904,3462276,6609,63523,1209056,2079,2,155,1,4,1172,1
Parabacteroides_distasonis_56985,700038806,ERR912110,6709,2542039,357585,1648365,2862,1220,79495,362363,2802,1065,278090,1286002,60,155,196087,3654953,6966,54166,1031153,1770,4,150,1,5,1059,1
Parabacteroides_distasonis_56985,700095213,700096047,405,2528159,355603,1639369,149,117,3123,14221,125,57,352480,1625148,24,60,246686,4620178,8580,2150,40435,78,3,57,0,0,57,0
Parabacteroides_distasonis_56985,700095213,ERR911959,289,2522736,354806,1635863,100,82,1947,9058,75,16,352859,1626805,25,66,247027,4624805,8583,1331,25801,42,1,65,0,0,16,0
Parabacteroides_distasonis_56985,700095213,ERR912059,290,2528471,355615,1639589,103,84,1947,9069,72,15,353668,1630520,31,69,247587,4635375,8598,1332,25830,45,1,68,0,0,15,0
Parabacteroides_distasonis_56985,700095213,SRR341697,281,2515925,353595,1631316,100,79,1800,8465,69,16,351795,1622851,31,63,246648,4613310,8595,1231,24119,45,1,62,0,0,16,0
Parabacteroides_distasonis_56985,700096047,ERR911959,583,2529534,355854,1640266,224,137,4881,22480,195,71,350973,1617786,29,66,245684,4599103,8571,3340,63980,120,2,64,0,0,71,0
Parabacteroides_distasonis_56985,700096047,ERR912059,580,2534636,356570,1643575,227,136,4813,22233,190,71,351757,1621342,37,65,246219,4609215,8592,3298,63281,120,2,63,0,0,71,0
Parabacteroides_distasonis_56985,700096047,SRR341697,573,2520906,354307,1634567,227,132,4940,22694,194,72,349367,1611873,33,60,245014,4582025,8580,3375,64584,123,2,58,0,0,72,0
Parabacteroides_distasonis_56985,700096865,700117682,101,2485361,349187,1611796,17,48,59,181,5,0,349128,1611615,12,48,244913,4581802,8130,23,514,6,1,46,1,0,0,0
Parabacteroides_distasonis_56985,700096865,700121919,98,2498099,351451,1620101,23,49,160,597,8,0,351291,1619504,15,49,245680,4604678,8154,99,1692,0,0,47,2,0,0,0
Parabacteroides_distasonis_56985,700096865,700173546,96,2498121,351443,1620129,15,56,195,710,6,1,351248,1619419,9,55,245732,4604356,8169,105,2025,0,0,55,0,0,1,0
Parabacteroides_distasonis_56985,700096865,ERR911962,1212,2498281,351571,1620287,476,261,17712,82339,454,178,333859,1537948,22,83,233106,4372989,7749,12654,233973,390,4,78,1,0,178,0
Parabacteroides_distasonis_56985,700097291,700117069,119,2539103,357177,1646520,28,68,117,411,3,0,357060,1646109,25,68,249813,4679835,8679,63,1170,0,4,64,0,0,0,0
Parabacteroides_distasonis_56985,700098867,700106465,2952,2533720,356261,1642957,1180,612,45573,207653,1137,482,310688,1435304,43,130,218415,4079832,7665,31153,590744,1062,2,128,0,3,478,1
Parabacteroides_distasonis_56985,700098867,700106836,547,2533678,356354,1643022,173,187,4022,17781,129,72,352332,1625241,44,115,246832,4620263,8628,2656,50612,75,1,114,0,1,71,0
Parabacteroides_distasonis_56985,700098867,700172813,748,2541338,357629,1647929,301,200,4653,21517,256,102,352976,1626412,45,98,246844,4623749,8643,3281,61180,90,1,97,0,0,102,0
Parabacteroides_distasonis_56985,700100227,700107930,2057,2538492,356959,1646130,884,376,26796,122501,829,292,330163,1523629,55,84,231286,4331588,8013,18672,348177,654,2,82,0,1,291,0
Parabacteroides_distasonis_56985,700100600,700107059,10,2511336,352475,1628293,5,2,59,234,4,1,352416,1628059,1,1,247741,4627793,8643,31,671,0,0,1,0,0,1,0
Parabacteroides_distasonis_56985,700100600,700116076,613,2515600,353241,1631101,256,136,7531,34459,248,98,345710,1596642,8,38,242924,4538542,8460,5174,97999,204,2,36,0,0,98,0
Parabacteroides_distasonis_56985,700100600,ERR911965,2578,2516060,353286,1631423,1076,443,30316,141329,1044,392,322970,1490094,32,51,226217,4236091,7974,21935,401377,675,0,51,0,1,391,0
Parabacteroides_distasonis_56985,700100600,ERR912037,2177,2517655,353514,1632475,878,395,20945,96892,842,331,332569,1535583,36,64,233423,4365094,8232,14847,275400,429,1,63,0,2,329,0
Parabacteroides_distasonis_56985,700100600,ERR912061,1574,2518104,353612,1632784,641,285,15908,73596,627,232,337704,1559188,14,53,237098,4432114,8352,11249,209224,315,0,53,0,1,231,0
Parabacteroides_distasonis_56985,700100600,ERR912065,1587,2518100,353593,1632753,642,287,15906,73718,628,225,337687,1559035,14,62,237099,4431651,8355,11270,209563,321,0,62,0,1,224,0
Parabacteroides_distasonis_56985,700100600,ERR912110,6403,2513283,352894,1629663,2656,1154,72251,332443,2604,1015,280643,1297220,52,139,197519,3687202,6939,50338,945302,1689,0,139,0,6,1009,0
Parabacteroides_distasonis_56985,700102356,700171115,928,2544961,357768,1650240,346,231,14965,68168,322,177,342803,1582072,24,54,240282,4497486,8448,10341,193818,345,0,54,0,0,177,0
Parabacteroides_distasonis_56985,700105940,700171115,945,2551875,358943,1654790,348,234,14611,66658,326,181,344332,1588132,22,53,241049,4514854,8493,10092,189558,324,0,53,0,0,181,0
Parabacteroides_distasonis_56985,700106465,700106836,2840,2531203,355848,1641368,1144,584,40181,181890,1103,455,315667,1459478,41,129,222172,4148495,7767,27178,517532,960,1,128,0,2,452,1
Parabacteroides_distasonis_56985,700106465,700172813,3075,2536154,356620,1644518,1258,612,46112,210441,1226,491,310508,1434077,32,121,218239,4076336,7656,31573,598667,1083,0,121,0,4,486,1
Parabacteroides_distasonis_56985,700106504,700171679,10,2561742,360497,1661142,4,2,49,231,2,0,360448,1660911,2,2,252041,4721740,8952,38,652,3,0,2,0,0,0,0
Parabacteroides_distasonis_56985,700106836,700172813,778,2536486,356770,1644812,309,205,6409,28720,274,105,350361,1616092,35,100,245442,4594227,8607,4324,81707,129,0,100,0,1,104,0
Parabacteroides_distasonis_56985,700107059,700116076,619,2526031,354998,1637887,259,137,7569,34627,251,99,347429,1603260,8,38,243696,4557600,8484,5200,98474,207,2,36,0,0,99,0
Parabacteroides_distasonis_56985,700107059,ERR911965,2547,2525773,354958,1637742,1068,438,30380,141627,1037,389,324578,1496115,31,49,226909,4253426,8010,21979,402236,666,0,49,0,0,389,0
Parabacteroides_distasonis_56985,700107059,ERR912037,2156,2527684,355234,1639001,877,397,20943,96751,842,335,334291,1542250,35,62,234229,4384256,8265,14807,275026,420,1,61,0,1,334,0
Parabacteroides_distasonis_56985,700107059,ERR912061,1543,2528177,355333,1639318,632,281,15898,73530,618,231,339435,1565788,14,50,237845,4451128,8391,11271,209010,309,0,50,0,0,231,0
Parabacteroides_distasonis_56985,700107059,ERR912065,1559,2527942,355283,1639157,635,284,15870,73459,621,227,339413,1565698,14,57,237835,4450862,8397,11267,208804,306,0,57,0,0,227,0
Parabacteroides_distasonis_56985,700107059,ERR912110,6378,2522863,354542,1635886,2652,1152,72074,331417,2600,1011,282468,1304469,52,141,198381,3708048,6978,50206,942371,1674,0,141,0,5,1006,0
Parabacteroides_distasonis_56985,700107189,700171115,908,2446264,340526,1585863,336,231,14265,65879,310,172,326261,1519984,26,59,232724,4319227,8001,10090,187217,330,0,59,0,0,172,0
Parabacteroides_distasonis_56985,700116076,ERR911965,3101,2535502,356762,1644081,1305,550,37256,172732,1279,494,319506,1471349,26,56,222988,4183220,7839,26591,490735,870,1,55,0,2,491,1
Parabacteroides_distasonis_56985,700116076,ERR912037,2732,2537016,356985,1645074,1120,511,27772,127986,1090,440,329213,1517088,30,71,230229,4312932,8103,19451,363895,612,3,68,0,2,437,1
Parabacteroides_distasonis_56985,700116076,ERR912061,2146,2537629,357094,1645483,890,396,23472,108274,880,336,333622,1537209,10,60,233317,4370114,8196,16464,307821,537,2,58,0,1,334,1
Parabacteroides_distasonis_56985,700116076,ERR912065,2160,2537599,357077,1645450,890,401,23321,107763,879,336,333756,1537687,11,65,233403,4371438,8220,16380,306390,519,2,63,0,1,334,1
Parabacteroides_distasonis_56985,700116076,ERR912110,6732,2533040,356404,1642539,2825,1236,77544,356278,2776,1109,278860,1286261,49,127,195423,3656451,6909,53887,1013168,1779,2,125,0,6,1102,1
Parabacteroides_distasonis_56985,700117031,700172132,3913,2545030,357892,1650337,1578,783,57179,263151,1514,640,300713,1387186,64,143,210634,3943466,7458,39932,748288,1233,2,141,0,1,636,3
Parabacteroides_distasonis_56985,700117031,ERR911954,3775,2550598,358856,1653974,1581,736,55459,253336,1529,590,303397,1400638,52,146,213092,3981211,7611,37911,720948,1149,2,144,0,1,589,0
Parabacteroides_distasonis_56985,700117031,SRR341698,3812,2531981,355683,1641804,1532,772,55539,256056,1460,620,300144,1385748,72,152,210657,3939072,7515,38839,728114,1215,2,150,0,1,618,1
Parabacteroides_distasonis_56985,700117682,700121919,99,2486894,349206,1612748,21,48,120,476,5,1,349086,1612272,16,47,245132,4583518,8166,79,1349,0,1,46,0,0,1,0
Parabacteroides_distasonis_56985,700117682,700173546,129,2487118,349239,1612904,21,70,234,879,10,4,349005,1612025,11,66,245148,4582737,8190,132,2505,0,1,64,1,0,4,0
Parabacteroides_distasonis_56985,700117682,ERR911962,1218,2487199,349364,1613022,477,259,18207,84786,461,190,331157,1528236,16,69,232104,4344852,7752,13084,240872,402,5,64,0,0,190,0
Parabacteroides_distasonis_56985,700119562,ERR911993,446,2526614,355567,1638503,160,152,3834,16405,130,76,351733,1622098,30,76,246307,4611380,8607,2398,46757,60,4,72,0,1,75,0
Parabacteroides_distasonis_56985,700119562,donald4-11-7-0_,1158,2513466,353407,1629861,469,283,17807,81095,436,179,335600,1548766,33,104,235680,4402380,8238,11920,230921,444,3,101,0,2,177,0
Parabacteroides_distasonis_56985,700121919,700173546,118,2498823,351327,1620565,23,68,205,783,8,3,351122,1619782,15,65,245913,4605222,8211,121,2228,0,0,64,1,0,3,0
Parabacteroides_distasonis_56985,700121919,ERR911962,1221,2499363,351521,1620959,487,261,17516,81718,459,179,334005,1539241,28,82,233308,4376645,7770,12697,232058,399,4,78,0,0,179,0
Parabacteroides_distasonis_56985,700164792,ERR912061,7500,2532854,356424,1642393,3176,1334,94007,429753,3122,1179,262417,1212640,54,155,184980,3446349,6591,64315,1222817,2127,2,152,1,3,1175,1
Parabacteroides_distasonis_56985,700164792,ERR912065,7571,2533275,356480,1642666,3197,1356,93218,426264,3140,1196,263262,1216402,57,160,185517,3457083,6606,63830,1212850,2112,2,157,1,3,1192,1
Parabacteroides_distasonis_56985,700166643,ERR911968,2828,2519130,354239,1633619,1194,550,33914,154843,1174,476,320325,1478776,20,74,224574,4204047,7707,23504,440197,828,2,72,0,2,474,0
Parabacteroides_distasonis_56985,700171115,ERR912173,965,2552198,358995,1654983,354,250,14859,67651,331,182,344136,1587332,23,68,240939,4512567,8490,10223,192394,336,1,67,0,0,182,0
Parabacteroides_distasonis_56985,700172132,ERR911954,2182,2548039,358301,1652274,919,432,32372,147828,873,347,325929,1504446,46,85,229003,4276277,8058,21907,420899,678,0,85,0,0,344,3
Parabacteroides_distasonis_56985,700172132,SRR341698,109,2531049,355387,1641190,28,52,168,755,4,2,355219,1640435,24,50,249399,4663173,8733,122,2143,0,0,49,1,0,2,0
Parabacteroides_distasonis_56985,700173546,ERR911962,1262,2499537,351538,1621080,490,286,18085,84148,468,180,333453,1536932,22,106,233028,4369971,7797,13001,239038,405,4,101,1,0,180,0
Parabacteroides_distasonis_56985,ERR911965,ERR912037,2234,2542637,357779,1648746,910,434,27349,126369,878,376,330430,1522377,32,58,230810,4328206,8115,19411,359066,630,1,57,0,1,375,0
Parabacteroides_distasonis_56985,ERR911965,ERR912061,2042,2542574,357796,1648735,841,398,27267,125391,813,348,330529,1523344,28,50,230984,4330942,8106,19264,356261,648,0,50,0,0,348,0
Parabacteroides_distasonis_56985,ERR911965,ERR912065,2058,2542773,357815,1648825,844,402,27782,127737,817,344,330033,1521088,27,58,230670,4324494,8100,19608,362946,657,0,58,0,0,344,0
Parabacteroides_distasonis_56985,ERR911965,ERR912110,6443,2538327,357127,1645982,2678,1197,80444,369876,2626,1076,276683,1276106,52,121,193681,3627818,6819,56142,1051587,1899,0,121,0,4,1072,0
Parabacteroides_distasonis_56985,ERR911993,donald4-11-7-0_,1473,2533705,356207,1642954,594,359,21450,96594,562,253,334757,1546360,32,106,235408,4395389,8283,14186,275107,489,2,104,0,2,251,0
Parabacteroides_distasonis_56985,ERR912037,ERR912061,1674,2544353,358079,1649860,649,367,18899,85727,616,295,339180,1564133,33,72,237476,4446571,8352,12916,243857,408,1,71,0,1,294,0
Parabacteroides_distasonis_56985,ERR912037,ERR912065,1692,2544276,358040,1649795,653,373,18717,84968,617,292,339323,1564827,36,81,237577,4448555,8349,12810,241680,414,1,80,0,1,291,0
Parabacteroides_distasonis_56985,ERR912037,ERR912110,5303,2540976,357525,1647711,2189,1045,63628,290357,2132,916,293897,1357354,57,129,206581,3858221,7260,43473,826125,1473,1,128,0,6,910,0
Parabacteroides_distasonis_56985,ERR912051,ERR912199,2121,2531069,356033,1641246,842,437,22719,105636,808,348,333314,1535610,34,89,233222,4365529,8079,15903,300492,513,2,87,0,3,345,0
Parabacteroides_distasonis_56985,ERR912061,ERR912065,66,2545181,358191,1650400,13,37,167,649,5,1,358024,1649751,8,36,250396,4690052,8805,106,1841,0,0,36,0,0,1,0
Parabacteroides_distasonis_56985,ERR912061,ERR912110,5711,2539618,357359,1646827,2377,1071,67097,306732,2321,935,290262,1340095,56,136,203776,3809360,7149,46182,872427,1587,0,136,0,5,930,0
Parabacteroides_distasonis_56985,ERR912065,ERR912110,5752,2540027,357416,1647074,2383,1084,68710,314363,2335,953,288706,1332711,48,131,202663,3788369,7101,47338,894116,1635,0,131,0,5,948,0
Parabacteroides_distasonis_56985,ERR912085,ERR912134,2176,2485052,349315,1611551,902,434,25586,115501,860,314,323729,1496050,42,120,227418,4252995,7737,17282,328714,507,2,118,0,3,310,1
Parabacteroides_distasonis_56985,ERR912142,ERR912176,1473,2527158,355457,1638846,609,263,18000,83753,592,200,337457,1555093,17,63,236127,4421028,8124,12670,238124,465,0,63,0,0,200,0
Parabacteroides_distasonis_56985,SRR341640,SRR413587,82,2500492,351483,1621421,26,25,321,1561,19,4,351162,1619860,7,21,246139,4604951,8490,220,4463,0,2,19,0,0,4,0
Parabacteroides_distasonis_56985,SRR341697,ERR911959,128,2516238,353643,1631526,32,65,147,588,3,1,353496,1630938,29,64,247859,4636273,8682,97,1667,0,0,64,0,0,1,0
Parabacteroides_distasonis_56985,SRR341697,ERR912059,125,2521694,354395,1635050,34,64,147,595,3,2,354248,1634455,31,62,248400,4646274,8691,96,1689,0,0,62,0,0,2,0
Parabacteroides_distasonis_56985,SRR341698,ERR911954,2113,2534807,356051,1643634,880,424,31210,143065,828,333,324841,1500569,52,91,228551,4265026,8130,21264,407274,657,0,91,0,0,332,1
Parabacteroides_distasonis_56985,SRR413602,SRR413608,3062,2468057,347206,1600610,1267,538,43197,197211,1264,499,304009,1403399,3,39,213383,3989641,7173,29655,561063,915,0,39,0,1,496,2
